anime_id,watching,completed,on-hold,dropped,plan to watch,total
40664,205,2407,96,60,5104,7872
18639,116,1371,80,67,1370,3004
23299,81,4813,80,116,1369,6459
34300,6042,68609,1481,2629,28051,106812
1548,277,1330,263,185,2616,4671
40855,2783,8,645,317,1057,4810
5968,144,4350,83,149,1178,5904
11101,35,290,16,61,312,714
17427,16,100,5,43,104,268
27451,15,228,13,67,72,395
44069,10535,18288,1092,635,27096,57646
34511,16,155,8,56,106,341
1033,3070,84936,1395,575,61982,151958
37571,966,2347,423,2775,6063,12574
43624,1,10,0,5,9,25
962,3774,32028,2925,1650,30731,71108
28049,21,373,7,55,105,561
9548,42,1161,29,74,374,1680
9088,623,5841,315,259,5386,12424
6276,129,3467,64,63,2427,6150
39533,23216,302183,7860,9193,99031,441483
20743,94,5641,93,128,1485,7441
40302,11,112,6,20,85,234
2398,363,42823,246,241,5264,48937
612,344,2631,286,378,2760,6399
588,274,9200,182,245,2921,12822
32902,20455,142904,6841,3913,73445,247558
32041,28,406,8,32,188,662
33019,3241,23526,1343,2008,10797,40915
3298,1484,19666,1364,1902,11182,35598
17833,29,244,20,67,191,551
39944,100,1784,45,51,988,2968
51013,8,222,4,7,77,318
40200,12,864,8,19,147,1050
42766,1,14,2,14,32,63
32255,12,88,4,57,121,282
2859,272,2071,153,143,1115,3754
36764,9,199,2,16,39,265
35234,15,47,7,47,114,230
39540,3,54,2,17,47,123
51128,1,0,0,0,486,487
23107,26,171,19,86,269,571
42760,4,27,5,35,43,114
36106,12719,171376,4490,1595,64346,254526
40570,4,88,1,28,33,154
39916,3,32,4,23,23,85
29667,14,187,7,47,87,342
4074,35,603,11,70,548,1267
47945,0,3,0,9,15,27
5075,237,1035,183,188,1392,3035
39195,35260,518887,13904,19955,110896,698902
4599,29,454,23,96,197,799
2302,77,2626,65,162,1176,4106
5934,24,491,24,55,337,931
47164,2,0,1,1,97788,97792
30158,7,92,4,34,58,195
2577,254,4264,249,361,2191,7319
48859,118,97,29,122,1253,1619
1951,881,13395,355,177,12835,27643
47163,3,2,3,0,17675,17683
1955,53,1321,35,83,753,2245
2447,543,4678,270,255,1587,7333
23847,30772,741401,11589,8263,112243,904268
4733,46,319,20,70,489,944
856,8138,75709,6063,5815,55443,151168
40645,9,148,0,33,77,267
35553,6,225,2,23,35,291
3668,567,2409,621,985,3899,8481
17815,65,3530,33,54,532,4214
10112,20,182,17,52,304,575
35972,51131,241748,15125,14490,96896,419390
1817,322,20354,229,165,3825,24895
29,986,7573,790,683,8977,19009
2420,122,1491,63,61,1692,3429
10794,1799,94307,690,623,14658,112077
46630,65,42,28,51,282,468
48391,284,0,84,278,643,1289
36564,221,3308,168,236,2977,6910
36006,0,0,0,0,6489,6489
7705,4248,17735,3873,8076,16189,50121
30634,11,67,6,37,111,232
38348,85,74,36,51,721,967
35327,136,6820,93,148,2198,9395
15977,6,162,8,47,60,283
49063,575,2597,54,81,570,3877
31387,55,2042,25,51,676,2849
36740,30,43,12,66,135,286
32366,2750,50664,840,573,17720,72547
1301,388,8913,224,180,7461,17166
32818,10,120,5,77,45,257
38658,3,322,0,13,39,377
120,19463,335485,14786,19500,102974,492208
26111,28,216,13,74,438,769
43665,0,16,3,10,11,40
20651,1573,45617,654,332,23162,71338
9311,712,5691,396,275,2241,9315
35726,427,2799,194,181,865,4466
378,87,3229,66,67,1163,4612
18007,66,55,45,100,255,521
10736,46,1076,29,82,774,2007
5890,349,2803,200,200,1263,4815
42501,7,145,6,25,94,277
41051,1406,5497,439,530,7588,15460
38131,6,97,2,62,36,203
17163,19,236,10,64,161,490
4101,73,133,57,93,538,894
38262,1085,3849,279,682,3535,9430
42965,81,729,15,33,251,1109
36036,23,47,6,35,44,155
30066,26,241,14,36,203,520
49854,6484,22011,856,902,13311,43564
26159,25,104,8,50,222,409
32667,1378,13514,719,668,3036,19315
4473,1522,17474,816,881,8498,29191
32876,38,40,11,123,289,501
22993,8,88,5,66,71,238
33712,1850,7018,682,479,4114,14143
944,1033,8918,1226,1140,7775,20092
2333,186,1955,197,240,1815,4393
3920,126,637,81,97,673,1614
47005,6,109,1,5,15,136
2561,163,2375,204,330,1034,4106
16562,16,114,8,57,119,314
5272,31,334,11,59,212,647
37561,2607,11864,1351,4780,12441,33043
5054,371,1842,211,173,1365,3962
10766,112,3410,88,131,1451,5192
13599,8969,85696,6988,7199,58974,167826
41505,9,266,0,14,50,339
49762,171,1553,109,90,907,2830
13085,11,300,6,36,98,451
38470,6867,19,1275,693,2910,11764
769,265,5811,226,240,2583,9125
42121,7,202,4,6,47,266
36516,20578,44583,9557,26267,55665,156650
1009,62,2071,60,93,889,3175
48909,2,16,4,23,28,73
38919,25,33,16,47,219,340
41109,26098,71506,6605,6356,87373,197938
31662,6,130,2,46,48,232
36491,715,5295,146,260,2137,8553
17497,196,1101,132,224,1437,3090
5584,68,879,36,41,769,1793
35627,15,71,9,34,122,251
40737,4,130,1,7,32,174
36544,223,794,78,96,1430,2621
6666,40,2476,14,29,408,2967
34678,47,1061,20,50,568,1746
36862,5849,167439,1687,531,132201,307707
6431,19,791,9,44,126,989
41807,50,123,23,119,696,1011
1790,51,1100,45,50,519,1765
38764,7,180,1,11,29,228
34835,47,895,27,93,517,1579
41586,93,1270,39,73,857,2332
19849,23,183,19,74,227,526
19305,23,165,26,113,302,629
30121,13,55,6,65,46,185
4715,160,12800,120,78,3083,16241
39320,3,202,5,10,34,254
35419,9,80,2,23,49,163
48517,94,0,20,70,133,317
37087,1107,24122,424,439,6425,32517
41025,166744,209117,32488,21011,209987,639347
1252,163,3394,114,120,3060,6851
284,470,6214,538,523,5008,12753
38276,3634,19135,1870,4776,13062,42477
8956,32,286,22,84,201,625
48025,0,3,0,10,15,28
42358,1,93,0,11,27,132
26297,10,33,1,45,55,144
9289,18382,138688,12755,10564,123204,303593
43661,0,7,1,8,8,24
1938,85,751,44,55,860,1795
10590,941,5616,465,364,2469,9855
6558,571,2887,329,327,2235,6349
4698,424,2843,210,196,1311,4984
38702,6,310,3,19,92,430
39401,11,80,13,27,141,272
35170,7,58,0,43,38,146
24991,4295,124328,2253,2204,31499,164579
48109,7,0,3,9,25,44
29801,84,1410,57,89,1392,3032
36447,158,233,51,131,809,1382
688,769,11131,793,1097,9694,23484
9375,374,2027,195,177,1328,4101
1298,87,3190,64,49,1204,4594
3556,126,937,86,101,521,1771
37533,4,141,1,9,30,185
33177,8,81,1,43,55,188
39872,16,582,3,20,113,734
49941,1,163,4,17,60,245
18627,21,66,9,50,182,328
30976,7,27,3,44,34,115
12223,103,1448,89,79,2113,3832
9858,34,503,17,79,299,932
10375,9,283,4,30,128,454
1788,287,2023,188,207,1350,4055
468,2053,104812,1146,529,36825,145365
22119,593,4105,325,300,1898,7221
21053,22,84,7,58,154,325
38964,4,201,2,14,37,258
29267,8,76,3,37,57,181
48643,5,0,3,0,17375,17383
6293,168,2137,75,70,1559,4009
30054,7,40,1,43,40,131
35335,0,0,0,0,4444,4444
9327,301,1536,175,155,1041,3208
1853,475,2654,526,500,4458,8613
48979,0,30,2,12,12,56
27419,248,4693,137,82,3066,8226
40403,1582,3792,611,2591,7828,16404
38495,5,115,2,10,31,163
2318,43,1097,32,64,551,1787
19983,14,102,11,89,152,368
2083,105,1359,63,61,1141,2729
43231,0,10,2,7,8,27
33879,17,174,14,49,198,452
3455,30411,365366,20469,31748,118761,566755
48086,0,5,0,9,15,29
34975,246,764,125,319,2409,3863
40806,195,864,62,67,1302,2490
197,1027,12775,1022,1731,6760,23315
5178,861,24604,401,486,11677,38029
36766,9,240,2,11,40,302
2969,436,29529,301,243,6646,37155
26213,1692,65721,770,1011,16672,85866
35280,6,28,1,37,33,105
12809,18,69,11,68,131,297
9013,70,510,41,87,612,1320
36643,48,323,11,46,306,734
12835,25,114,9,93,145,386
1133,1147,18243,1004,1359,6546,28299
40902,44686,249984,12990,12041,99663,419364
38104,227,1973,122,152,2148,4622
3070,35,917,18,46,358,1374
38098,2158,8526,1028,1626,6650,19988
48405,0,0,1,0,15159,15160
9260,9535,304980,2808,1362,136514,455199
36196,317,2535,128,228,1359,4567
33480,18,65,5,68,62,218
28257,46,1133,32,90,766,2067
42178,254,275,71,176,1759,2535
41217,23,676,1,39,231,970
2191,193,1893,140,153,987,3366
1805,186,2947,148,188,1766,5235
49997,0,60,0,4,13,77
17649,26,74,11,49,224,384
4362,269,6944,151,298,1853,9515
37696,6,104,3,18,25,156
7108,84,2527,71,88,1716,4486
40395,13,175,11,32,96,327
38975,1155,1185,341,239,1209,4129
20797,9,63,5,46,67,190
6069,146,1749,83,147,1494,3619
50583,0,0,0,0,1212,1212
36866,59,55,26,54,332,526
45448,21,34,4,34,79,172
6773,8397,145784,7234,6780,53245,221440
8729,10,250,6,36,64,366
3795,282,1236,161,152,986,2817
32195,137,671,91,84,492,1475
895,586,93721,330,281,5419,100337
1883,83,980,78,183,658,1982
32613,2720,5229,1297,1970,11058,22274
3546,51,408,35,85,411,990
21891,12,266,3,21,51,353
4697,69,868,45,103,487,1572
36611,16,50,7,56,74,203
6574,4612,42214,2968,3006,27488,80288
29141,16,329,11,31,150,537
30940,7,26,2,48,42,125
3584,77,675,54,89,415,1310
16690,95,2547,49,39,1122,3852
50379,1,0,0,0,1439,1440
33392,1971,22396,1040,3644,7470,36521
1280,416,5213,423,494,4164,10710
7157,33,653,26,57,512,1281
15129,21,62,8,46,93,230
3877,91,418,62,114,680,1365
29035,333,3701,178,224,2075,6511
35161,6,23,3,33,32,97
36030,10,380,12,28,175,605
43523,28890,157413,2821,4529,55655,249308
33262,20,49,10,92,98,269
2633,25,869,25,84,383,1386
5028,1872,50045,761,733,10833,64244
32926,21,138,10,88,179,436
4561,117,793,74,114,548,1646
42447,2,27,4,32,41,106
40964,5570,8906,1613,6045,12163,34297
28087,16,73,19,63,141,312
38493,11,123,1,28,70,233
35053,7,22,2,39,37,107
16776,18,74,11,49,195,347
37982,32282,428830,10325,26065,104863,602365
43666,1,10,2,5,10,28
18967,12,94,5,63,110,284
5602,21,273,7,38,187,526
49961,0,5,0,8,14,27
33947,183,3756,123,247,2508,6817
36720,5237,9647,1211,824,4743,21662
7633,12,74,5,59,122,272
570,3695,82256,1324,709,58356,146340
31164,33,193,16,82,282,606
14807,2532,60533,1161,448,36765,101439
6922,3236,149112,1627,1620,43948,199543
48187,1,7,2,17,20,47
34836,295,1949,99,297,839,3479
184,712,9950,867,1244,6270,19043
22673,1915,45809,846,595,10076,59241
4166,232,3342,145,120,2417,6256
4028,1182,23318,1225,1132,7869,34726
48910,6,20,2,12,38,78
1949,53,2402,34,47,655,3191
40641,5,69,0,15,43,132
37343,38,0,10,50,86,184
13509,11,71,11,69,82,244
27949,31,248,12,34,301,626
7809,30,1111,21,90,494,1746
2348,171,1298,124,132,857,2582
30089,19,158,10,55,122,364
4132,41,536,28,121,496,1222
22865,9945,101274,4944,6443,42469,165075
38594,4095,77162,1556,644,71919,155376
34402,639,4233,323,2005,3075,10275
25889,25,371,12,52,252,712
46328,1,5,0,13,19,38
17521,30,149,18,94,253,544
29733,8,46,4,48,67,173
9343,17,116,10,41,219,403
39344,3,40,4,24,50,121
41308,3,97,1,4,11,116
15609,835,32742,400,236,8365,42578
17443,13,119,12,76,156,376
42985,54,566,24,45,308,997
43551,3,69,4,6,16,98
4705,576,23326,497,441,7213,32053
24977,72,0,27,74,134,307
48764,8,207,2,7,29,253
24045,21,97,14,32,168,332
19859,512,3555,272,201,1431,5971
38487,4,261,3,17,50,335
33335,17,356,13,54,208,648
49820,0,0,0,0,537,537
12901,17,97,2,52,142,310
36782,114,524,36,45,893,1612
10504,346,8650,303,261,5621,15181
13163,2135,642,1783,1653,3974,10187
1830,315,10534,399,194,3131,14573
350,2477,28576,2303,2474,10612,46442
8496,31,512,10,33,329,915
12865,55,1534,34,91,696,2410
23677,31,170,23,76,186,486
38855,3,161,4,11,26,205
1419,171,6617,127,124,2863,9902
41399,272,1518,171,143,1199,3303
31630,13622,46659,9643,23734,27842,121500
38010,23,43,10,94,135,305
30445,89,985,41,63,1058,2236
43594,0,8,1,6,9,24
48652,340,1873,140,130,536,3019
1979,75,2539,33,52,1092,3791
30160,9,268,3,27,55,362
36066,9,144,2,11,51,217
22043,106739,542505,48336,59287,100134,857001
2395,276,1545,147,160,1030,3158
2452,237,4781,134,99,3597,8848
1031,56,1520,33,69,857,2535
9383,20,124,12,67,178,401
38121,5,94,1,61,46,207
36124,12683,63981,4829,13150,36323,130966
12907,129,2382,52,103,851,3517
3005,174,2806,88,94,2187,5349
23971,11,98,14,91,104,318
2782,297,7187,183,218,4185,12070
33513,1804,59333,1250,930,30425,93742
38735,4796,63028,2533,7225,31764,109346
28285,2262,101910,747,451,19341,124711
37915,81,260,37,71,1182,1631
675,141,1511,123,168,1524,3467
32886,133,1456,83,115,1467,3254
3574,824,13508,580,445,10108,25465
2518,167,1571,233,151,838,2960
9689,115,341,102,229,724,1511
7619,180,1194,214,301,1324,3213
26221,8,32,3,43,41,127
50203,0,0,0,0,8316,8316
49423,1,0,0,0,694,695
43602,1,69,2,9,16,97
3022,43,397,55,97,386,978
3640,52,781,31,61,608,1533
36673,10,106,1,19,39,175
36683,786,8881,325,335,8441,18768
35928,17213,115099,6040,16178,71232,225762
40009,28,129,17,46,197,417
34475,131,1062,58,90,1231,2572
3456,420,23212,211,200,5608,29651
20,182917,1932815,79703,116884,92044,2404363
12359,16,187,19,78,117,417
10419,1194,6639,592,368,3229,12022
6571,49,273,57,108,661,1148
29455,6,282,1,37,42,368
35821,7593,53339,3489,6312,33507,104240
33034,627,12310,301,163,8829,22230
28573,7,28,1,45,37,118
33173,271,3816,184,79,2090,6440
1215,362,15921,323,256,4568,21430
36858,170,733,86,108,3633,4730
43489,4,45,1,13,22,85
24843,7,231,3,35,53,329
24109,11,545,6,23,101,686
39677,19,39,4,43,198,303
35823,1242,62717,389,169,11130,75647
572,3751,257830,1792,931,56958,321262
632,115,4307,103,124,1667,6316
11873,18,363,20,89,145,635
20093,21,121,7,58,106,313
36672,9,198,3,19,50,279
2249,124,2870,79,109,1875,5057
3467,4662,84054,2948,3951,30298,125913
4490,98,872,64,86,500,1620
27577,11,94,15,96,110,326
29687,64,312,34,162,569,1141
40137,460,1603,197,999,2849,6108
34019,12911,86313,5138,9695,52307,166364
712,615,8574,630,670,4221,14710
37263,21,51,13,72,166,323
31741,17863,310517,8344,6878,78734,422336
551,2562,47080,984,841,10731,62198
49995,1,50,0,3,9,63
8630,13636,243272,7633,12355,67407,344303
31919,60,987,35,75,742,1899
33044,67,102,30,198,289,686
36811,7,113,1,23,37,181
2419,134,2233,75,71,2163,4676
34790,16,55,3,37,65,176
3628,162,899,93,105,581,1840
39794,1936,7,664,311,1011,3929
23125,14,47,4,52,78,195
2727,122,1153,109,252,1161,2797
49936,8,52,7,12,115,194
28297,51668,320182,34365,34084,138881,579180
28749,24,60,12,52,232,380
26153,8,48,5,45,75,181
33219,446,3826,273,171,10413,15129
6379,194,4788,124,88,2983,8177
247,1514,8916,1272,1334,9427,22463
613,426,2178,380,474,2225,5683
20117,22,222,12,80,118,454
48548,2,1,11,0,88994,89008
8141,26,256,13,58,230,583
39378,2,13,2,29,39,85
48544,23,0,9,30,53,115
40840,2,87,2,9,25,125
749,63,603,48,122,400,1236
34223,167,804,96,992,1055,3114
28117,11,70,9,54,119,263
840,768,9323,608,685,6166,17550
23047,833,4504,434,350,2344,8465
2833,31,686,21,78,515,1331
25341,861,9957,892,284,3420,15414
35295,16,49,8,85,65,223
25101,9,101,2,42,47,201
49569,310,0,22,21,380,733
34589,118,718,79,74,1961,2950
49199,44,106,17,21,276,464
30051,10,70,4,50,71,205
32887,19492,254289,8702,16317,85788,384588
19995,19,96,13,101,146,375
37096,196,0,47,154,787,1184
3705,190,1162,97,133,725,2307
33654,8625,90539,3064,5520,33557,141305
2112,1501,24951,1225,1600,12485,41762
10691,79,4515,25,38,780,5437
3421,142,3352,85,91,2042,5712
38012,17,202,15,34,580,848
4651,256,956,223,232,1624,3291
4851,100,2702,87,84,1936,4909
218,2615,21962,2332,1888,19294,48091
3785,4646,279818,2043,808,75983,363298
35343,815,2059,306,229,1296,4705
44212,0,0,0,0,1260,1260
3675,68,774,28,67,820,1757
39584,506,3737,173,294,12225,16935
41286,306,748,98,148,1369,2669
8890,68,222,38,73,806,1207
40598,3,158,3,8,25,197
37450,86828,1054507,26944,27489,199209,1394977
30131,13,74,9,86,86,268
232,27234,239138,23798,15995,78113,384278
5233,748,20301,689,483,7854,30075
18227,44,110,22,110,207,493
3912,111,731,60,94,474,1470
34658,1976,47632,662,656,22482,73408
32408,17,132,6,44,80,279
33145,81,1137,74,111,1294,2697
695,186,4176,148,181,2473,7164
38403,127,55,34,68,915,1199
26235,6,56,3,40,41,146
33398,159,0,36,231,752,1178
9958,623,24014,424,314,9540,34915
37347,38692,489317,10007,11922,114103,664041
1778,194,1650,153,198,1480,3675
11067,832,4746,451,345,2455,8829
50854,1,0,0,0,596,597
245,54887,389634,39162,21288,197289,702260
2972,65,990,36,57,1006,2154
6855,31,483,14,54,334,916
35909,61,236,38,76,493,904
37422,294,2947,122,193,2286,5842
49967,0,4,0,12,14,30
41093,2117,4362,451,743,5880,13553
42380,12,388,12,14,85,511
21831,11,530,5,46,99,691
39406,5,11,2,29,26,73
22845,13,45,4,49,48,159
30970,11,41,4,50,104,210
44007,1,18,2,21,29,71
48004,0,7,1,11,16,35
21349,598,3043,290,254,1218,5403
19747,35,199,33,94,266,627
42044,48,964,16,47,368,1443
24987,405,6004,251,207,1450,8317
10016,109,4293,51,59,1416,5928
45587,814,2969,165,670,1607,6225
40738,1542,7629,594,2131,10220,22116
32663,55,162,27,108,329,681
1582,100,1532,57,82,940,2711
36342,288,1531,162,133,4101,6215
3757,42,800,18,54,387,1301
2803,161,1267,159,210,1940,3737
37691,4,95,0,19,25,143
1943,7939,287804,3347,1717,143806,444613
42284,337,1456,53,111,620,2577
4514,58,1300,45,157,341,1901
35635,174,753,66,115,1066,2174
8815,43,871,37,116,340,1407
7303,177,4717,119,164,2297,7474
43542,0,8,1,5,10,24
1375,607,7325,501,494,5211,14138
23393,14,270,14,91,113,502
34997,39,201,12,40,244,536
4644,77,476,41,85,386,1065
37932,8142,42923,1765,1096,43683,97609
9421,23,268,3,23,206,523
34445,1428,17500,614,450,16222,36214
585,4109,212887,1678,617,68940,288231
1162,100,1702,81,92,1071,3046
36808,8,125,1,21,31,186
4615,59,523,60,139,510,1291
38219,44,50,20,47,454,615
1819,78,1259,51,68,1050,2506
7713,10,207,9,48,94,368
43341,0,17,1,7,8,33
38425,843,3106,278,273,5876,10376
40901,326,2044,108,80,2387,4945
1369,229,15658,131,139,2282,18439
25143,383,15565,149,230,5806,22133
40727,4,182,3,9,66,264
779,631,57886,222,249,3704,62692
10720,22,2018,9,28,361,2438
33884,15,151,2,31,79,278
29293,11,645,10,37,173,876
29979,21,1467,13,38,151,1690
38088,897,16635,316,262,15308,33418
28927,22816,551669,9458,8390,80634,672967
41117,5,32,4,29,53,123
49154,0,0,0,0,875,875
41854,67,199,12,32,347,657
31953,22590,228624,11482,13264,111117,387077
36197,63,391,35,86,1223,1798
27911,3065,18696,2011,3098,13083,39953
33011,686,4521,306,852,2470,8835
40246,148,2113,61,58,1798,4178
457,63728,263737,48518,22863,323134,721980
38093,4,55,1,38,36,134
27915,20,145,8,70,164,407
14583,208,2652,161,101,2083,5205
23861,15,108,7,66,170,366
49742,0,0,0,0,137,137
6131,223,378,316,764,705,2386
28689,7,62,12,70,72,223
3388,173,859,154,203,1434,2823
4205,191,8968,142,85,2438,11824
40321,100,573,102,82,3056,3913
38773,7,212,0,17,48,284
3602,112,2049,92,66,1778,4097
9533,16,77,8,61,113,275
40979,1933,8213,333,433,8559,19471
5529,142,8711,128,167,2292,11440
33708,36,536,21,76,290,959
12763,31,204,48,150,333,766
39125,3,25,1,33,32,94
40573,2,91,1,12,19,125
1161,321,2279,375,419,2587,5981
7216,22,178,12,57,181,450
6355,29,854,15,41,319,1258
6156,14,256,6,72,118,466
2891,423,9615,276,223,9902,20439
37722,8885,54103,3305,7065,31867,105225
15039,4777,171509,2764,1449,82949,263448
40100,878,3830,279,303,3971,9261
6687,19,79,18,54,223,393
20457,8070,76510,4330,4533,54660,148103
34908,5,266,5,23,62,361
34577,61697,788473,11869,15719,89624,967382
1734,504,7514,275,426,5010,13729
42272,2,86,4,9,38,139
35686,385,0,91,137,303,916
28811,62,455,36,76,744,1373
30,94462,1054011,45520,26073,276580,1496646
3040,172,2578,107,153,897,3907
5665,79,348,47,80,356,910
7343,40,262,27,90,193,612
29673,8,269,4,40,90,411
73,5140,187903,4047,2445,43752,243287
4732,318,2280,229,220,1354,4401
7427,55,553,40,39,669,1356
18031,12,159,7,43,115,336
935,5733,54709,5084,5652,34288,105466
31853,240,13586,106,126,4678,18736
91,627,36979,316,277,6314,44513
49975,9,74,4,14,57,158
38738,4,94,3,32,34,167
34325,170,7756,148,144,1551,9769
31348,12,173,3,55,81,324
2971,742,13888,589,374,6587,22180
20909,1218,21627,905,658,14220,38628
267,7132,77077,6031,5876,73638,169754
5081,85527,769269,55372,40840,300166,1251174
11673,13,71,8,56,221,369
516,8238,23939,11182,9660,15149,68168
3737,93,4984,79,249,1041,6446
10244,20,200,7,63,81,371
3499,39,554,45,133,333,1104
9252,527,48200,306,220,7366,56619
35727,824,9847,486,444,2500,14101
42247,4,99,1,11,46,161
50638,0,0,0,0,3372,3372
2161,1365,9547,1133,1406,14947,28398
3027,182,4763,123,101,2621,7790
24705,9105,74390,5474,12958,43034,144961
38670,1290,5356,645,1684,6466,15441
10592,152,1712,100,88,2717,4769
1379,1057,30980,585,266,18514,51402
49600,3,154,3,6,18,184
4723,121,241,90,118,1141,1711
42836,21,707,7,24,182,941
50599,1998,0,83,103,2535,4719
1731,1851,28557,1486,1204,16596,49694
29505,14,141,2,39,66,262
41919,0,0,0,0,4090,4090
34409,23,298,8,46,165,540
456,887,7718,965,1188,7507,18265
36964,13,53,8,61,121,256
6861,34,721,11,41,468,1275
27393,16,75,6,51,107,255
32603,6814,108423,2391,2883,25995,146506
748,172,2007,91,111,2203,4584
4394,24,769,11,53,143,1000
6951,382,37165,212,217,4931,42907
34052,260,823,153,676,587,2499
6418,118,4208,82,111,1710,6229
9063,624,28012,397,218,9041,38292
33520,1028,18757,485,539,19317,40126
3915,108,687,110,235,1026,2166
3690,49,307,32,90,407,885
4391,37,1176,18,53,218,1502
37197,8,165,0,17,57,247
5785,54,1703,28,51,711,2547
37154,3658,11605,1569,6798,15794,39424
44847,4,14,5,10,41,74
39605,580,6307,294,202,7628,15011
49860,129,1598,25,37,499,2288
19555,12,60,3,48,65,188
693,402,4192,355,439,3460,8848
10163,11067,173726,7800,10226,72702,275521
1892,36,552,25,65,315,993
18655,1598,7609,746,495,4969,15417
34438,2228,47717,961,712,33469,85087
29862,21,192,21,56,185,475
41097,17,0,11,33,42,103
39519,896,13342,265,1094,4907,20504
6211,10234,135489,8004,6340,110256,270323
8599,470,11922,276,177,5073,17918
30410,22,258,13,78,159,530
38129,5,89,4,57,37,192
34949,19,22,3,33,66,143
7375,777,15576,608,390,5823,23174
29750,21,108,9,71,126,335
43232,0,8,2,6,9,25
2642,12,166,11,38,101,328
5589,172,900,93,152,672,1989
1771,104,915,60,95,827,2001
30118,9,64,8,64,47,192
6150,10,107,11,36,156,320
39297,1,141,2,11,38,193
34107,496,4596,323,218,1607,7240
1370,70,5579,43,75,1633,7400
33108,9,71,8,75,56,219
22611,9,204,8,59,125,405
162,826,12702,1147,1627,5580,21882
44590,36,470,37,48,497,1088
28735,18143,94527,11334,7716,127925,259645
28953,20,527,7,31,207,792
50406,0,0,0,0,483,483
50064,4,81,2,3,32,122
28851,38282,1605234,5269,2540,235991,1887316
22461,14,193,7,44,116,374
37600,97,679,77,113,3399,4365
36784,580,3371,253,971,2200,7375
49858,0,0,0,0,20817,20817
38786,4,86,2,28,33,153
36183,7,151,1,12,34,205
7531,15,111,10,88,134,358
5647,64,456,46,89,751,1406
26319,7,35,2,46,42,132
39157,2,32,5,23,42,104
33447,926,8415,420,1428,3862,15051
41822,11,49,3,11,112,186
34161,1852,36110,753,974,30157,69846
42132,31,90,10,31,154,316
3881,67,363,49,109,538,1126
1394,74,1265,49,66,785,2239
10500,297,11690,190,100,6659,18936
32845,6,192,3,19,40,260
35716,0,1,0,0,12866,12867
12057,782,6991,394,340,2519,11026
18819,14,126,17,76,131,364
9424,35,298,16,79,168,596
50436,0,0,0,0,726,726
36550,11,64,7,43,52,177
32899,25247,243623,12227,22425,82810,386332
22955,810,1557,813,1840,4268,9288
12291,14026,170956,10005,11961,81040,287988
7374,32,279,37,102,378,828
15663,19,201,7,45,120,392
23101,533,3609,286,219,1337,5984
33194,23,122,9,53,170,377
30208,8,76,3,38,27,152
7836,25,173,21,77,323,619
7510,52,497,25,62,775,1411
1434,97,3785,90,92,2034,6098
3427,184,1325,119,141,997,2766
38916,92,391,27,71,398,979
17539,664,4125,355,332,1880,7356
22821,29,117,14,109,153,422
48694,164,213,52,37,737,1203
3358,3528,44542,2732,2639,31728,85169
42653,477,662,157,260,988,2544
37618,1413,8107,361,405,6959,17245
10501,77,3918,40,81,937,5053
25061,27,89,8,49,250,423
12979,6757,46619,6483,8959,14296,83114
10819,91,2282,82,82,1512,4049
37483,55,226,37,45,3442,3805
1992,84,887,53,79,751,1854
2482,67,894,42,49,673,1725
38467,295,698,49,90,871,2003
39664,7,29,7,45,48,136
36312,6,19,1,37,29,92
33075,1058,36714,470,284,13728,52254
38571,8,47,3,34,56,148
3825,38,308,31,109,460,946
32859,4,223,3,23,39,292
28055,10,296,4,47,81,438
42803,943,6984,331,172,4310,12740
17485,11,181,8,41,138,379
48616,40,151,22,38,320,571
10671,945,13011,621,1059,6913,22549
12117,427,33074,203,241,3747,37692
1390,177,1735,101,142,905,3060
30959,7,37,4,54,44,146
26249,6,30,3,41,44,124
9982,9086,124176,4024,2181,16314,155781
39184,2823,9795,1341,1988,13029,28976
38977,10,204,2,18,80,314
40256,2158,20581,1191,2542,8033,34505
41136,4,60,7,36,67,174
270,25652,422143,17856,18746,146628,631025
1361,327,63628,167,296,3504,67922
40477,239,3391,85,128,3095,6938
11869,31,2361,12,63,364,2831
33822,7,21,2,43,37,110
39217,44,2383,44,49,721,3241
3999,553,2781,298,261,1849,5742
33378,797,8443,267,179,11534,21220
45540,1,11,0,15,19,46
49571,528,0,19,24,412,983
39356,11,64,12,50,190,327
2714,56,509,35,39,601,1240
2117,188,8911,156,213,1530,10998
430,2704,264401,1466,868,35377,304816
6297,34,495,12,51,260,852
38539,11,121,7,17,131,287
5873,33,1215,12,62,251,1573
2332,372,7985,169,131,4903,13560
38034,1504,9578,681,541,2789,15093
33187,26,6013,18,47,232,6336
16035,11762,108452,9087,12923,57539,199763
29373,13,63,18,58,59,211
40746,7189,71807,1671,3471,25242,109380
49527,1,64,2,2,10,79
7571,60,662,36,39,506,1303
2107,602,49053,451,400,7495,58001
32526,9852,100381,4837,6272,40661,162003
42339,1,19,2,12,30,64
5821,34,210,18,111,151,524
7862,41,623,21,63,322,1070
21935,14,108,3,62,75,262
48026,1,20,0,5,8,34
33978,12,141,11,61,109,334
33979,476,5348,275,252,1453,7804
22325,11,42,5,40,132,230
42748,3,57,2,14,28,104
50404,2,0,1,0,16588,16591
34373,18,91,8,51,92,260
46652,89,0,20,103,385,597
758,287,9257,231,164,4490,14429
5670,1007,7557,995,1339,7801,18699
4004,583,3434,319,273,2088,6697
31521,228,5810,136,84,2334,8592
33429,12,205,0,35,59,311
4244,59,234,51,78,616,1038
20423,349,20643,244,149,5963,27348
29797,8,123,4,38,61,234
29989,9,329,6,29,72,445
29351,6,63,2,61,59,191
50916,3,2,1,1,10984,10991
1395,75,1280,45,73,769,2242
4509,26,473,19,62,274,854
664,686,25450,596,459,13421,40612
12679,11561,46062,7022,6170,79356,150171
3050,564,5899,328,287,2184,9262
32928,6,154,0,21,23,204
49,1145,36246,922,961,10330,49604
1552,41,439,27,57,461,1025
44026,7,29,3,43,62,144
40639,369,3325,182,168,1139,5183
35330,21028,99710,11530,21531,40094,193893
6351,2054,213866,1109,681,26381,244091
5588,65,316,32,80,257,750
49678,0,40,0,3,9,52
24695,657,31406,308,183,7549,40103
8584,76,739,38,64,1063,1980
39505,1,13,1,30,24,69
759,4355,151417,1786,737,84435,242730
8290,288,1497,189,143,1046,3163
19069,10,86,5,33,104,238
36743,6,217,0,24,48,295
35391,21,617,6,40,86,770
33366,37,309,20,41,236,643
1275,253,1612,175,170,1135,3345
3843,42,837,30,85,460,1454
1409,116,2223,101,129,1366,3935
48742,3,0,1,0,6694,6698
34717,7,50,1,32,35,125
39498,9,212,3,43,50,317
10465,5243,27483,2660,4367,28568,68321
49233,2,1,2,1,76749,76755
42333,11,36,4,49,78,178
33422,15,93,0,44,69,221
38015,151,181,113,38,17791,18274
1784,118,812,64,113,549,1656
39212,1,141,0,18,30,190
6811,9914,174735,6399,4040,53091,248179
5311,73,602,55,144,419,1293
5017,12,888,5,30,208,1143
928,189,3867,144,308,852,5360
40868,5,111,1,16,45,178
19629,385,2043,200,184,901,3713
36943,4892,28405,1364,4634,19386,58681
2410,254,1814,139,167,1036,3410
635,681,9123,729,1026,5713,17272
24501,41,29,13,65,159,307
1263,324,2793,192,207,1789,5305
1456,174,1738,197,304,1816,4229
10713,575,27068,318,169,7909,36039
249,69684,366267,64162,53524,140383,694020
34191,7,26,1,50,42,126
37433,644,1455,270,704,3105,6178
4196,2213,37657,1431,1675,16691,59667
31886,2394,22172,910,907,4059,30442
60,8864,123508,10317,10432,57915,211036
7474,249,7972,156,111,2777,11265
1484,239,4303,111,150,3119,7922
50119,1,25,0,2,4,32
28761,68,7792,33,92,860,8845
1835,608,7160,615,682,2997,12062
38265,1172,3022,407,292,1434,6327
29231,34,304,19,50,259,666
30290,301,2450,213,196,5254,8414
50405,0,0,0,0,908,908
2551,107,921,64,109,541,1742
29165,432,3483,389,268,2799,7371
4929,80,367,38,107,769,1361
27411,1021,21339,510,278,20088,43236
30868,1099,23544,517,815,15928,41903
24071,20,372,28,64,334,818
35263,10,251,4,20,100,385
27945,537,6962,367,179,5890,13935
43395,0,9,1,5,11,26
15537,2685,10413,1062,746,5762,20668
41179,4,401,5,7,41,458
22567,12,144,2,40,82,280
42802,4,86,0,6,21,117
6444,6597,50773,6714,6318,41787,112189
22429,2959,46893,1131,1056,7028,59067
885,2898,58104,1191,613,53286,116092
38807,807,33250,284,599,8249,43189
6609,392,11585,310,689,1414,14390
12141,28,570,19,46,457,1120
34929,7,314,3,20,61,405
687,6178,84955,7347,10332,24102,132914
1493,241,2851,204,159,1967,5422
2980,73,410,75,104,630,1292
30600,88,3728,41,70,1016,4943
50099,1,0,0,0,2594,2595
13359,15,396,4,34,109,558
31370,790,6724,508,1120,3411,12553
50051,0,0,0,0,783,783
1708,142,799,82,151,1066,2240
35015,4120,44744,1768,1750,27642,80024
42805,9,23,3,11,254,300
36806,7,91,3,24,46,171
5143,73,268,45,111,632,1129
9525,36,237,18,46,389,726
32811,6,306,1,19,61,393
5550,81,486,51,91,451,1160
6882,494,11247,337,306,3942,16326
16740,76,1427,51,61,747,2362
23347,19,120,14,82,127,362
19815,77459,1707523,33281,48393,234539,2101195
40833,1797,6388,415,787,2979,12366
3946,78,1853,65,76,1514,3586
50685,4,0,1,0,3429,3434
2937,195,11810,183,136,3726,16050
33515,254,2372,188,176,923,3913
677,182,931,135,149,1645,3042
6421,4378,101452,2543,974,33498,142845
37481,1128,4574,573,2009,6229,14513
2224,213,1838,167,224,2140,4582
34076,3394,28879,1636,1023,22574,57506
45519,1,9,1,11,19,41
30370,8369,81794,3607,1070,21660,116500
3977,76,1553,80,78,1233,3020
31147,6142,28286,4890,10427,32377,82122
27821,4062,244846,1292,794,32606,283600
9232,361,6341,151,230,1742,8825
35022,8,57,2,37,55,159
18577,14,99,8,41,76,238
2310,49,600,29,54,628,1360
39148,1,19,2,28,34,84
484,162,6017,148,119,2692,9138
35306,12,56,8,49,83,208
28789,182,10303,118,171,2673,13447
47777,0,0,0,0,2036,2036
39147,3,15,1,30,27,76
33791,11,467,4,38,68,588
31427,117,577,65,122,471,1352
38510,9,243,2,23,57,334
20231,17,69,14,72,139,311
36163,10,126,3,39,77,255
1844,592,5981,831,801,4621,12826
12549,18193,255659,10354,20249,70082,374537
40060,22050,189368,8788,10450,68150,298806
28245,10,591,6,50,126,783
39262,2,14,2,26,31,75
49214,191,564,79,98,1348,2280
48495,10,46,5,50,140,251
35233,13,42,8,49,109,221
31551,25,577,13,30,202,847
30072,6,120,1,30,54,211
11209,2730,38116,997,691,11402,53936
30278,44,253,22,41,587,947
42074,20,151,14,36,322,543
49314,6,93,2,3,35,139
138,2794,113876,993,932,17887,136482
32446,62,1858,16,66,467,2469
44060,0,0,0,0,288,288
2567,44,1243,38,168,292,1785
33814,970,11305,402,2649,3517,18843
39960,1021,9418,292,547,4612,15890
45766,1,5,0,10,18,34
49587,668,0,26,20,1413,2127
36173,29,2439,7,21,183,2679
41923,1980,1676,340,342,3623,7961
47639,3458,3318,1065,4045,12218,24104
320,1674,38840,694,720,17051,58979
34399,1058,3181,350,281,1453,6323
26233,6,32,4,41,47,130
1271,161,2390,91,110,1597,4349
33205,60,3067,18,50,591,3786
49469,0,0,0,0,27210,27210
6025,52,598,28,102,311,1091
20517,2506,30544,1775,846,14968,50639
408,582,52060,318,200,9833,62993
387,10842,103969,8931,6007,112495,242244
14995,590,3493,361,248,1882,6574
33821,6,28,3,48,36,121
33433,14698,71302,8504,18308,49954,162766
454,251,14359,231,358,4664,19863
37942,4,62,4,38,37,145
34258,13,31,5,41,110,200
39939,2,132,1,9,25,169
1842,1187,53130,564,563,7333,62777
11687,36,4250,9,54,404,4753
10087,58644,935367,29442,20283,275602,1319338
43688,2,69,2,6,14,93
38701,10,433,2,23,81,549
2225,952,22133,1025,1230,5832,31172
37620,127,101,49,75,1167,1519
35383,49,330,22,111,228,740
464,879,68799,508,358,11271,81815
12259,18,256,11,44,220,549
590,995,15302,711,974,6695,24677
48763,2,13,3,23,26,67
17245,15,681,6,24,132,858
38585,0,0,0,0,5500,5500
571,135,1498,99,177,1381,3290
13969,25,1495,14,43,368,1945
3383,106,769,54,80,441,1450
9691,54,328,33,55,522,992
40780,75,1248,25,81,644,2073
15051,19059,258189,10501,14174,105494,407417
39220,7,106,1,17,44,175
18397,14287,319222,6670,2529,47158,389866
8920,62,707,23,39,787,1618
10178,1477,7064,859,470,9950,19820
8661,8,528,6,43,103,688
37286,152,2677,51,97,4528,7505
43350,59,438,19,60,388,964
5040,10311,122035,7262,5547,64320,209475
34366,22,656,12,55,277,1022
3437,423,918,361,285,2176,4163
36700,38,0,13,51,79,181
33797,1274,10274,674,1715,5413,19350
29387,35,36,9,62,74,216
35448,346,4784,158,517,1193,6998
13055,2678,80243,1803,781,15219,100724
37839,0,0,0,0,8199,8199
24231,7405,136726,4412,3679,33960,186182
3266,257,13186,194,158,3212,17007
202,14355,146033,15901,12692,110490,299471
8604,16,558,5,46,106,731
6133,33,223,26,79,216,577
33047,11897,99266,6271,12327,63980,193741
8671,8,256,5,31,65,365
4010,729,8270,436,437,2771,12643
16906,215,560,181,310,587,1853
3332,908,1338,621,364,4895,8126
41223,667,2067,161,182,2742,5819
4563,99,859,65,140,631,1794
40048,611,4010,340,262,1634,6857
38535,14,133,8,29,60,244
3303,191,1388,123,130,757,2589
4049,39,380,34,113,291,857
28677,28556,502754,14272,16068,119285,680935
36670,10,188,0,21,42,261
35443,34,114,13,56,312,529
9544,256,19502,96,110,3299,23263
28201,16,100,7,52,146,321
43418,15,230,6,12,88,351
18137,26,80,21,111,181,419
2051,89,927,82,113,995,2206
40000,6,119,1,9,24,159
37511,71,1072,19,59,513,1734
39071,10699,55258,4043,4344,48408,122752
2421,35,494,8,34,314,885
2288,284,3029,332,506,2476,6627
11835,75,413,41,94,591,1214
28655,14,415,1,28,83,541
40487,38,35,15,101,161,350
1189,283,2832,364,422,2115,6016
40369,395,5135,121,162,3199,9012
27629,469,3855,363,619,3083,8389
34374,432,6512,229,177,6013,13363
37430,101833,813245,22743,25420,145804,1109045
26099,14,40,3,46,73,176
35496,8,82,2,28,56,176
20757,1265,5556,522,448,2694,10485
2166,898,15891,979,1120,7664,26552
2075,64,275,55,101,518,1013
3060,250,2956,173,224,3607,7210
2547,557,11835,454,488,4321,17655
32748,8,364,4,23,62,461
10706,15,101,7,58,100,281
2299,50,1119,35,62,713,1979
2955,490,6197,297,250,1683,8917
2282,108,318,84,103,856,1469
1722,6037,52000,4226,4330,27057,93650
35514,10,147,1,11,35,204
45653,2,0,0,0,28704,28706
1228,113,1839,70,93,1246,3361
49200,459,13774,131,61,4279,18704
48701,0,0,0,0,335,335
28657,13,837,6,38,139,1033
149,4590,86877,4270,9589,26057,131383
35926,4543,729,1459,599,2630,9960
39544,5,106,0,7,24,142
10056,10,138,5,66,92,311
11759,29560,443367,22217,43259,119239,657642
33508,163,461,67,127,1036,1854
20955,24,336,12,79,229,680
42163,411,1,105,58,1321,1896
3095,130,1096,65,93,1270,2654
30435,14,91,6,36,115,262
50483,1,29,0,4,5,39
34738,153,1713,54,199,656,2775
5849,90,1221,68,107,1250,2736
35169,6,17,1,40,35,99
17887,69,957,28,36,540,1630
2390,1389,15528,2240,3495,4778,27430
49195,1,9,4,10,15,39
47972,6,178,5,5,69,263
930,855,3610,649,392,8211,13717
6953,27,3273,22,60,380,3762
45704,4,15,4,12,48,83
4365,389,2973,250,199,1540,5351
2178,397,10326,163,152,5321,16359
683,51,1275,53,55,573,2007
30905,15,88,0,41,79,223
30870,547,7815,415,454,13823,23054
32851,10,171,2,20,36,239
1973,78,1607,41,73,1385,3184
38785,3,86,2,24,36,151
1820,83,941,45,74,842,1985
24197,16,793,4,21,102,936
13769,58,223,32,71,358,742
25519,7890,61903,4957,6167,56792,137709
33511,859,14785,798,692,19560,36694
26097,8,59,4,47,70,188
3644,147,760,84,128,537,1656
2422,81,1292,40,58,1194,2665
22877,14647,233319,5826,10000,62552,326344
7152,533,1904,484,608,3842,7371
29575,4199,32621,1645,1364,9195,49024
48006,1,8,2,17,26,54
13223,286,3864,179,226,1404,5959
3110,118,1333,130,174,1499,3254
9617,4164,218459,1963,1009,60685,286280
44161,0,7,0,11,10,28
38271,20,574,19,33,348,994
5690,3153,85517,1892,1038,28300,119900
37905,0,0,0,0,8480,8480
42187,324,1115,39,83,457,2018
47971,1,11,0,12,19,43
7528,25,764,12,60,272,1133
1989,34,1948,25,60,373,2440
36050,8,487,3,14,79,591
39922,3,119,2,10,18,152
32607,6945,38575,4789,6668,39103,96080
37509,2039,6518,925,4176,9733,23391
21405,14873,226504,7781,9095,89050,347303
50673,418,1592,73,36,1479,3598
40543,31,98,19,35,347,530
20031,15293,233518,8608,9766,87294,354479
369,5896,33576,4866,4863,62883,112084
8687,6523,6,2641,3312,3415,15897
48068,1,5,0,11,15,32
48072,1,6,1,10,18,36
34153,20,264,6,33,132,455
33731,24663,253844,12922,16737,95984,404150
915,483,9001,487,571,3298,13840
33674,18322,536058,5695,5446,180635,746156
44931,1404,61155,366,123,34053,97101
7981,20,245,20,94,133,512
34785,17,183,1,17,81,299
33522,173,2537,74,115,1790,4689
2392,115,10503,50,126,779,11573
31737,15228,308668,5588,7897,43803,381184
32797,12,37,3,55,55,162
31914,9201,49207,4713,11309,33724,108154
13311,10,528,4,38,93,673
39833,29,279,12,28,307,655
9172,24,342,13,62,254,695
33975,104,1044,57,369,604,2178
3806,77,394,63,140,611,1285
642,244,13936,241,149,3471,18041
7505,232,0,58,171,322,783
47614,107,711,35,36,751,1640
1845,250,1633,244,223,2046,4396
35639,17798,127722,7673,11834,97053,262080
35372,56,0,13,80,89,238
30133,19,335,7,33,268,662
33730,404,6651,186,224,6337,13802
42697,7,186,5,26,110,334
3488,258,2767,134,123,5017,8299
31464,7,61,2,42,47,159
38741,452,1283,94,177,1058,3064
49903,1,61,0,4,16,82
2607,147,2623,81,100,2767,5718
22031,48,430,22,32,310,842
49692,1,0,0,0,11135,11136
4549,568,5534,431,461,4330,11324
2433,607,5329,300,273,1941,8450
30543,556,2361,234,217,1325,4693
37598,3746,15854,1551,4273,16696,42120
3317,73,395,68,110,507,1153
32218,25,125,13,48,211,422
2540,214,1532,130,150,1081,3107
44412,518,1981,45,81,898,3523
8191,21,69,18,49,194,351
25623,35,77,12,60,373,557
10471,71,1487,35,66,546,2205
33085,22,84,5,89,122,322
40555,5,141,2,7,27,182
18507,37643,508895,21424,33547,111677,713186
23267,17,344,9,56,97,523
28593,445,6303,267,176,4493,11684
32438,13171,117884,5693,23281,43486,203515
35681,9,94,9,36,326,474
38031,713,3849,314,246,1807,6929
19669,619,38694,308,256,7939,47816
3613,2916,31126,2218,2548,28572,67380
49943,762,1,253,98,503,1617
5251,762,22962,306,233,8328,32591
33552,14,231,15,43,137,440
43670,0,11,2,6,8,27
31430,4536,56260,1888,6874,14141,83699
5656,45,2142,54,103,728,3072
23871,62,1132,64,92,1052,2402
1936,62,546,60,125,740,1533
33193,35,215,26,63,309,648
18729,78,712,40,116,1106,2052
6115,474,23723,259,250,6345,31051
3542,87,584,47,96,409,1223
20261,31,189,26,54,171,471
10679,69,2561,54,97,1210,3991
4061,77,1318,76,113,733,2317
14189,1102,56910,513,238,13591,72354
16472,1039,7549,454,392,2887,12321
36315,8,20,3,41,37,109
721,7273,70433,7639,5543,56169,147057
35585,18,725,10,17,229,999
29485,17,39,5,54,57,172
36549,11,65,6,43,66,191
38891,206,1824,67,65,2568,4730
6413,47,1309,20,48,530,1954
2374,201,1357,115,131,729,2533
207,3291,26579,2079,1765,25196,58910
41192,9,236,0,35,69,349
288,2153,85234,2022,4919,5943,100271
10203,11,103,4,62,91,271
36226,71,177,40,65,398,751
33994,613,5686,327,243,10128,16997
7463,384,6630,237,299,3065,10615
3980,143,1151,80,135,574,2083
39682,4,111,1,16,19,151
33998,11,76,7,37,129,260
11739,2837,51645,1887,1277,23506,81152
17673,20,93,14,67,225,419
22513,30,2301,14,28,297,2670
29085,771,4652,341,264,1859,7887
912,438,1315,506,487,2964,5710
10338,513,2780,355,637,3083,7368
44077,2,44,0,2,7,55
1985,439,6102,403,567,2463,9974
12135,22,595,14,35,280,946
2028,24,257,15,51,239,586
39876,3,68,4,25,44,144
33545,11,452,4,31,98,596
33369,7,455,3,15,49,529
39299,1095,2107,375,245,1018,4840
40152,148,1255,85,92,1233,2813
27909,348,2917,204,187,1168,4824
29957,8,727,5,28,69,837
4548,8879,43219,5474,5963,76480,140015
20007,39,146,28,112,258,583
4841,107,590,50,105,670,1522
35720,357,3873,207,164,4263,8864
32665,37,187,11,51,305,591
2741,49,229,20,74,343,715
14077,281,4177,251,266,5102,10077
21353,9762,88180,6751,13827,41573,160093
22979,18,116,9,51,171,365
10923,136,4674,85,89,1785,6769
49379,3,14,3,20,22,62
28431,95,7415,69,119,1432,9130
10653,14,90,5,49,124,282
18119,10594,108098,5916,6197,65321,196126
29834,35,224,11,65,277,612
23065,16,478,13,30,236,773
18429,460,20628,231,227,5837,27383
4103,48,1137,18,51,518,1772
3522,101,1354,65,69,1577,3166
2409,763,6543,698,651,5190,13845
41276,32,0,18,50,83,183
11319,9603,306558,5394,5895,48978,376428
36754,16798,56633,6354,8135,44524,132444
2190,105,741,86,118,550,1600
45781,1,27,1,9,18,56
28053,23,566,20,52,324,985
40020,0,0,0,0,5995,5995
10469,308,10772,226,130,5615,17051
41094,16030,107213,3880,5843,53515,186481
2610,166,779,110,125,944,2124
35285,178,3990,100,92,3349,7709
40245,73,1798,29,37,1132,3069
2620,151,2893,119,158,921,4242
2203,329,2719,221,203,2549,6021
30721,2911,20244,1394,3229,18626,46404
2515,121,10735,115,129,1958,13058
35301,28,298,29,53,507,915
30262,192,3095,75,130,1036,4528
32895,963,4276,458,315,1917,7929
23713,10,34,4,41,49,138
17624,18,90,11,60,117,296
7479,96,218,49,108,739,1210
62,3293,37467,2969,4056,24074,71859
34845,59,0,30,57,136,282
9387,18,151,11,58,150,388
1029,1848,78510,1065,786,35705,117914
38328,15858,49530,6570,16013,51909,139880
6220,370,2706,214,223,1234,4747
50360,10,12,4,0,53403,53429
6299,104,3418,93,92,1560,5267
29830,299,3552,189,126,4348,8514
2871,734,6407,412,417,2464,10434
34639,753,3269,364,303,1790,6479
35905,12764,88554,4809,8840,53558,168525
38013,9,48,9,46,218,330
5819,113,1958,54,71,2330,4526
18391,91,954,65,124,622,1856
33878,16,178,14,48,196,452
211,185,1996,123,138,987,3429
38081,696,15250,253,155,9916,26270
48651,2547,0,719,241,961,4468
20533,2327,20545,1399,3417,10742,38430
38360,802,9747,374,163,9063,20149
50330,6,1,3,3,68326,68339
38484,5,22,2,37,37,103
1746,294,6576,367,813,2379,10429
2068,118,1065,65,85,1335,2668
49053,618,21826,202,96,31993,54735
8709,86,3937,99,128,1767,6017
38762,4,154,1,10,33,202
50549,3,0,4,0,27191,27198
10202,31,407,12,48,231,729
21055,20,506,5,29,99,659
39372,6,51,7,32,58,154
50737,6,159,0,2,53,220
43541,0,7,1,6,11,25
30157,6,184,1,35,38,264
48307,1,12,1,19,19,52
13935,45,646,28,70,501,1290
49361,998,9525,176,39,5104,15842
22113,162,1596,107,130,1679,3674
20123,15,84,7,53,108,267
40667,148,987,71,73,1350,2629
37103,765,12490,395,269,10584,24503
11123,3944,122265,1649,1870,13897,143625
447,620,8598,983,1394,5931,17526
13117,749,12984,384,275,11908,26300
39711,11,67,1,38,70,187
8208,88,1273,49,43,989,2442
5472,13,398,19,33,270,733
30651,778,2576,570,1441,1477,6842
22641,12,93,5,42,96,248
39453,2,11,4,36,31,84
42967,19,0,10,37,66,132
29980,30,1786,16,54,379,2265
9091,167,1499,134,115,744,2659
8644,16,121,7,53,118,315
35776,87,3048,46,33,969,4183
446,271,4772,350,464,3670,9527
38534,23,157,12,32,75,299
36456,129914,1547363,19538,16398,117097,1830310
1670,111,8134,93,153,1449,9940
1414,104,3478,95,87,2163,5927
31055,64,510,32,96,742,1444
2375,162,1231,99,120,578,2190
661,127,1620,94,130,1229,3200
4662,714,11915,585,632,5164,19010
12321,750,13603,387,728,7032,22500
3483,73,1586,65,74,1241,3039
17615,30,187,20,48,380,665
37067,8,122,0,21,44,195
33729,463,7269,211,245,6793,14981
2179,87,1246,62,106,1191,2692
3998,292,1489,161,145,1036,3123
20039,233,9532,136,106,3185,13192
1045,959,12134,877,1213,8005,23188
41522,4,24,5,51,44,128
22689,1206,25065,931,1003,6000,34205
21025,26,156,16,59,437,694
50414,0,0,0,0,2980,2980
8357,23,135,15,90,182,445
43814,19408,73373,2973,5981,34995,136730
45,33933,239783,33995,20622,112026,440359
14249,16,210,12,51,239,528
37892,6,21,2,38,44,111
7793,83,521,65,100,769,1538
8603,18,590,10,31,316,965
1475,159,4302,123,91,2162,6837
34549,1746,18782,620,411,16656,38215
40171,12,198,1,17,77,305
39039,77,143,19,155,532,926
33913,14,40,3,43,59,159
16928,172,4206,127,117,3134,7756
45486,2,0,1,1,23760,23764
10714,538,25561,281,163,7690,34233
8993,53,568,32,75,413,1141
50590,1,0,0,0,732,733
614,401,3175,333,430,4237,8576
4737,66,343,53,142,404,1008
49285,1102,1,124,364,1669,3260
8407,7106,217487,3644,4015,36368,268620
43243,0,11,2,7,11,31
3578,332,2590,197,207,1155,4481
9807,11,102,9,67,74,263
9391,30,169,26,62,321,608
4210,69,704,27,71,982,1853
19463,10,60,2,48,59,179
39199,12324,52057,4179,13132,30406,112098
2006,597,41305,329,372,5340,47943
1038,135,1127,96,109,827,2294
1146,255,10682,158,131,3055,14281
38252,772,3908,358,232,1468,6738
48073,0,3,0,9,15,27
40990,4,70,1,7,30,112
48779,1,0,1,0,5604,5606
291,942,20607,897,938,8599,31983
3272,743,3603,715,794,4229,10084
4037,843,24716,541,332,16494,42926
21603,23017,239837,16710,22518,110081,412163
1884,135,998,136,246,902,2417
10731,173,7346,105,136,2375,10135
37671,75,254,25,46,626,1026
38011,14,74,14,37,367,506
3854,75,894,72,87,1177,2305
12281,1099,15884,1021,980,7944,26928
42268,159,342,38,95,281,915
40192,943,7368,268,454,3013,12046
35785,7,168,4,19,60,258
20057,20478,155219,15932,12786,105800,310215
12461,5593,56696,3757,7258,30584,103888
28959,12,620,9,24,132,797
36432,20154,100546,8012,8994,76664,214370
31686,22,1259,4,33,154,1472
1775,335,1540,228,353,3873,6329
44089,2,43,0,2,4,51
40367,58,148,23,89,400,718
36952,305,0,104,95,2353,2857
36112,40,115,12,40,277,484
8215,79,257,41,85,793,1255
35137,33,243,22,53,330,681
42076,67,2909,11,34,175,3196
5570,58,441,42,97,309,947
2490,307,25650,248,228,4829,31262
8731,9,466,9,62,144,690
36543,45,0,17,63,71,196
22125,528,34418,290,233,7740,43209
30763,10,125,5,48,85,273
5152,440,41188,249,242,4690,46809
17167,32,243,23,61,312,671
38395,3338,15409,990,2299,13593,35629
36537,74,1024,40,75,2048,3261
13837,133,6156,113,153,2018,8573
31912,23,443,9,60,117,652
39896,4,107,0,13,22,146
37396,3461,98617,1394,1296,39760,144528
9675,905,45979,469,300,12147,59800
34820,233,3964,101,110,2763,7171
36000,1455,5431,665,4268,7679,19498
8180,23,285,21,55,340,724
5117,154,716,85,114,547,1616
31422,1375,7685,762,2558,6774,19154
9581,811,23283,636,465,6614,31809
9000,2141,34372,749,343,28465,66070
4810,303,1757,327,301,2830,5518
4680,37,418,27,61,625,1168
4496,194,1211,93,147,815,2460
40651,114,1663,41,109,890,2817
14359,119,1220,40,92,1183,2654
7709,9,179,4,32,120,344
22273,6401,74378,4073,6948,47171,138971
20855,46,3807,13,43,387,4296
28391,8992,74731,5115,12904,36651,138393
2936,115,786,62,103,396,1462
39361,7,67,13,31,139,257
42316,5,99,3,5,19,131
39075,4,107,1,19,23,154
17733,92,154,116,177,360,899
36838,9057,103082,2626,1556,53625,169946
35648,13,171,10,54,101,349
40679,14519,34542,4989,13576,28241,95867
1115,94,2071,47,59,1327,3598
26241,8,50,5,38,56,157
23615,19,177,15,49,278,538
26317,7,30,2,49,43,131
50662,2,29,0,8,9,48
5552,46,323,30,70,200,669
10743,16,603,6,46,112,783
41380,21433,133676,5404,16942,41032,218487
24923,7,56,3,63,64,193
34038,13,105,9,63,102,292
17659,70,1954,51,62,861,2998
34189,6,24,3,33,39,105
2311,59,797,40,63,1204,2163
43658,1,16,1,4,8,30
42780,1,87,1,10,17,116
3758,19,358,6,55,199,637
6731,24,289,19,105,215,652
12661,17,1257,4,27,154,1459
25259,175,2519,137,132,3511,6474
17955,23,322,4,46,146,541
38002,506,29038,250,130,7237,37161
2966,35088,429761,28652,18594,214844,726939
47409,52,69,24,26,1304,1475
6096,199,558,120,101,1385,2363
34643,10,53,5,47,51,166
3131,29,329,16,116,221,711
5091,60,800,41,120,339,1360
43760,0,0,0,0,1244,1244
22591,30,205,24,87,388,734
9127,95,1214,69,94,1294,2766
34392,6697,51200,2467,8139,41991,110494
2517,72,3236,67,82,1630,5087
18353,7,134,6,37,63,247
42143,137,6447,66,154,3119,9923
4214,9063,323188,5572,7891,35512,381226
34871,12,57,8,46,118,241
9332,980,26666,583,569,9808,38606
33045,982,5765,573,1269,4387,12976
2076,2813,5927,2211,1269,13425,25645
28215,1667,18241,903,1384,4841,27036
7646,24,109,12,95,274,514
50964,6,105,3,4,21,139
30982,9,26,2,46,51,134
41171,6,113,0,4,21,144
1511,219,1547,188,181,1096,3231
3812,29,419,24,101,183,756
45078,2,7,1,11,23,44
10572,3584,42660,2157,4358,23627,76386
3072,124,1461,73,91,1865,3614
28755,6908,360688,1260,1657,32616,403129
36956,314,3982,210,183,1078,5767
10323,26,102,24,55,159,366
40221,70636,505521,15257,21751,125285,738450
42378,7,212,4,8,29,260
38671,127730,620465,46913,60588,175972,1031668
4842,104,585,69,125,824,1707
14947,37,306,24,66,575,1008
34669,32,151,20,83,357,643
9345,57,141,25,84,551,858
28263,14,102,8,39,139,302
16355,5671,55113,4199,8987,29490,103460
36241,155,3691,88,110,1937,5981
2108,558,10853,674,657,3046,15788
28545,9,34,2,55,62,162
33135,14,82,12,87,84,279
48288,1,8,2,19,21,51
5909,8984,99441,6096,7495,58797,180813
6392,880,13039,324,443,4884,19570
40837,2,91,3,7,21,124
40141,21,22,7,67,73,190
30861,6,69,2,34,37,148
10460,8557,71650,6193,7710,74603,168713
12795,53,344,23,67,622,1109
37404,11,213,1,14,45,284
25285,1296,25370,611,405,6960,34642
57,13138,147552,11596,9392,115445,297123
1688,814,10667,844,1253,7774,21352
5594,14,92,8,66,110,290
40499,8,131,1,10,31,181
2370,251,2180,163,202,1135,3931
8337,123,2809,55,65,1929,4981
36626,29,105,10,46,229,419
23597,20,242,9,47,155,473
43493,0,8,2,6,11,27
8436,62,231,47,105,714,1159
33086,18,104,3,59,78,262
1428,106,2861,69,87,1744,4867
4013,40,392,30,96,263,821
11569,60,1197,44,86,847,2234
41443,3,142,2,6,25,178
34667,11,43,3,49,46,152
30237,384,5589,176,122,2718,8989
3481,62,1395,40,59,550,2106
5231,10448,131924,7863,10081,16760,177076
41061,210,10129,110,59,3994,14502
37510,67968,901192,15637,5994,187583,1178374
1250,3906,54338,4227,4683,22718,89872
30424,8,537,3,26,49,623
6883,126,1894,76,75,1935,4106
6846,13,495,4,38,101,651
13331,6180,122650,3691,2234,34507,169262
2204,551,3380,593,576,5542,10642
47988,0,3,0,10,11,24
1682,467,9103,439,535,5721,16265
2512,160,12783,118,130,2110,15301
12181,24,82,6,66,146,324
1703,580,2885,368,587,6185,10605
34102,13344,37812,8668,16794,56142,132760
861,15372,134041,14949,12698,105874,282934
43405,0,9,2,5,9,25
33474,13,213,8,55,184,473
4835,1966,183310,950,498,19897,206621
41780,146,2006,100,60,4267,6579
31493,76,410,35,60,615,1196
39989,126,5555,49,103,1136,6969
36489,4,186,2,13,39,244
1399,166,5606,152,122,2349,8395
15961,102,436,45,88,803,1474
15867,887,6763,443,423,2376,10892
38893,3,205,0,11,34,253
36728,96,390,58,158,656,1358
24019,14,109,2,33,66,224
27693,89,172,33,70,879,1243
21419,550,31354,259,283,4419,36865
30098,14,125,3,42,76,260
38810,220,6379,156,96,3047,9898
13507,11,81,10,53,82,237
41912,0,0,0,0,186,186
12887,27,139,33,115,183,497
40003,8,179,3,21,39,250
37436,2879,19594,1308,4462,28932,57175
29089,2394,5537,935,1154,13560,23580
5133,43,676,23,75,536,1353
43394,0,8,2,5,10,25
1224,494,5698,547,879,4919,12537
2106,802,2979,692,804,4608,9885
43361,0,10,2,9,9,30
3751,40,1161,22,52,658,1933
47776,0,6,0,8,12,26
35173,6,23,0,41,35,105
10153,558,13728,295,260,7119,21960
28487,5,35,2,40,36,118
29153,8,202,3,36,48,297
35387,10,227,3,27,53,320
10624,682,25956,398,218,10400,37654
7265,495,3177,254,248,2420,6594
9243,28,346,19,54,256,703
29747,10,45,4,59,51,169
1431,127,3718,96,101,2294,6336
34488,17,75,13,80,154,339
2212,107,2728,108,110,2475,5528
8774,18,401,8,95,245,767
32275,16,47,4,42,117,226
17705,186,1677,148,287,1336,3634
21899,1149,21548,616,570,14308,38191
2013,190,4574,123,91,2624,7602
24201,13,722,4,24,92,855
36410,32,89,15,52,215,403
1628,420,4131,307,458,3803,9119
42847,1847,1549,641,75,39129,43241
35490,16,71,12,85,75,259
48091,0,4,0,10,13,27
4489,160,799,93,94,646,1792
37340,816,744,277,205,921,2963
31834,12,390,5,32,82,521
8670,13,59,9,42,77,200
5924,117,1344,65,97,1775,3398
38748,6,447,3,24,92,572
41926,5,96,3,6,20,130
19597,24,298,10,46,208,586
30968,7,31,2,49,47,136
6287,378,19239,236,216,4282,24351
35781,620,5089,260,256,1718,7943
97,6465,80936,6880,5337,60621,160239
48576,33,139,13,26,261,472
32932,90,1000,52,96,941,2179
30343,9,52,2,50,61,174
2342,115,1014,47,97,712,1985
38309,3,86,3,15,27,134
33240,780,1493,518,794,3023,6608
40286,9,341,7,14,42,413
10061,12,154,5,70,96,337
34670,625,1830,251,356,3388,6450
17537,738,3619,388,294,1921,6960
32843,2687,13310,578,729,15862,33166
36259,6033,15671,2145,5107,11421,40377
5927,36,326,38,55,564,1019
35385,12,68,6,58,57,201
45612,36,58,9,40,111,254
3044,570,6548,751,924,3035,11828
16460,18,120,8,59,144,349
38909,15514,75705,4656,16726,32477,145078
3430,181,5840,114,118,3279,9532
4418,23,817,23,41,316,1220
2815,44,1020,70,135,265,1534
24781,2512,23940,1045,637,17236,45370
1412,6263,32566,4921,3022,42765,89537
40623,13610,45872,4486,13872,33275,111115
33213,26,141,19,60,133,379
38410,357,10966,109,93,2160,13685
43458,0,6,1,5,12,24
40734,772,2563,92,168,1238,4833
41744,4,183,2,14,22,225
15911,5537,45159,3428,3794,39205,97123
41303,5,112,1,3,12,133
4827,60,2185,53,83,702,3083
3633,130,1113,68,127,720,2158
36937,34,186,4,31,303,558
34591,8935,75994,2969,1811,70383,160092
37059,7,102,0,16,26,151
35206,68,1235,48,84,1112,2547
8218,14,262,9,31,286,602
50087,4,69,0,4,19,96
2238,484,13545,274,379,5099,19781
4057,504,3249,271,237,1634,5895
37097,8,79,4,46,43,180
48093,1,6,0,8,16,31
26137,18,105,8,78,159,368
39140,4,29,2,40,40,115
50466,3,53,0,1,7,64
34904,585,25147,257,427,4642,31058
17159,16,292,14,56,144,522
24135,2761,25164,1825,2744,20856,53350
5990,34,440,19,46,353,892
44004,1,18,0,17,29,65
28921,127,252,82,162,378,1001
4794,149,11642,124,171,2189,14275
42513,4,25,4,18,52,103
18199,54,215,24,73,208,574
7482,50,678,26,47,579,1380
4310,110,761,60,108,532,1571
25615,9,78,6,62,56,211
8894,110,7910,70,92,2083,10265
36269,85,708,77,115,1077,2062
40677,894,3334,441,715,4567,9951
6907,19,229,16,56,220,540
2377,246,1550,150,145,907,2998
36316,10875,55561,3982,11989,35303,117710
33454,39,270,18,56,433,816
4130,731,12326,740,1547,8814,24158
2497,429,3848,308,253,3817,8655
40423,36,67,16,108,228,455
5042,30146,191940,15661,15036,41255,294038
35586,57,83,20,45,379,584
37973,121,3277,62,75,2015,5550
31815,644,18001,270,658,6020,25593
32212,4316,8433,2318,3108,20260,38435
41207,342,2792,201,147,1224,4706
27785,69,840,70,210,607,1796
868,247,13395,213,122,4082,18059
1433,138,4793,112,112,2362,7517
33689,15,638,7,24,142,826
43323,6,85,3,7,18,119
421,386,5375,409,534,3924,10628
22537,1583,33511,765,754,7162,43775
23135,3134,4016,1901,2175,7558,18784
7581,433,2508,277,190,1619,5027
30826,472,1230,521,851,1737,4811
961,560,5061,470,407,2864,9362
50485,1,26,0,1,4,32
33966,1559,5068,652,2061,7416,16756
2784,130,4968,103,96,1801,7098
37413,15,616,7,14,114,766
43660,0,8,2,6,7,23
35434,6776,35562,3166,8584,31749,85837
43613,1,7,0,9,11,28
23227,724,38003,361,161,8248,47497
30347,3818,142179,1401,713,21835,169946
48612,445,2924,118,92,5282,8861
48012,0,3,0,10,14,27
41405,441,806,88,373,1103,2811
39226,19,247,13,36,271,586
49335,1627,0,475,150,538,2790
9600,220,2083,113,147,1212,3775
33486,119515,1885325,19001,15921,96993,2136755
28639,10,638,9,29,125,811
36305,643,10578,271,168,7268,18928
5241,29,195,21,63,223,531
2346,235,5836,104,124,3290,9589
10261,19,149,14,60,279,521
39624,3,7,1,31,24,66
5266,59,744,37,45,712,1597
49521,1,1,0,0,5632,5634
12637,150,10588,73,123,1846,12780
8966,33,779,21,61,475,1369
7273,73,1420,22,50,1084,2649
3279,31,260,17,67,297,672
4189,1238,5324,1032,1535,13088,22217
30417,20,75,12,73,160,340
7529,15,105,13,87,155,375
31693,9,75,3,60,61,208
10242,13,62,4,63,61,203
30100,436,10828,289,270,6183,18006
1499,134,645,69,96,535,1479
30980,9,29,2,47,59,146
10711,4943,120484,1753,1337,53432,181949
1781,282,1914,185,190,1746,4317
358,782,13119,630,640,9028,24199
5060,19317,133152,17160,21584,49273,240486
9656,10718,308834,6650,4734,65005,395941
3270,669,10515,634,856,5604,18278
5287,20,305,22,90,200,637
48594,4,17,3,26,44,94
16914,732,5122,426,298,2099,8677
47194,4,0,7,0,25113,25124
22975,15,139,10,72,127,363
25383,50,3068,68,91,551,3828
35056,11,21,1,37,49,119
32190,162,3546,72,53,1977,5810
1789,58,2330,75,74,1056,3593
21925,1159,8266,565,416,3007,13413
17605,19,197,4,57,129,406
1101,250,11120,169,118,2894,14551
39200,3,122,1,11,26,163
50339,1,0,2,0,9167,9170
50909,2,45,1,1,4,53
2830,29,380,24,89,338,860
4320,141,4969,112,98,2300,7620
23425,239,3672,252,156,4897,9216
38090,4,109,1,11,28,153
10012,8311,104642,5546,3942,53877,176318
1469,1289,27493,1989,3308,5787,39866
37706,602,0,250,162,536,1550
6327,113,1256,89,160,2261,3879
49454,31,0,13,27,90,161
1968,164,6877,130,148,2855,10174
30922,96,1966,35,51,1224,3372
9837,71,609,30,48,732,1490
1284,76,983,48,73,820,2000
31845,18060,144971,6652,17996,61021,248700
49320,2,0,0,0,4524,4526
39204,6,466,2,14,51,539
1231,351,9614,414,418,2631,13428
38052,28,1034,18,41,254,1375
16566,14,102,7,59,117,299
39586,24245,80902,8313,5485,103909,222854
6702,205263,873308,124687,178563,167349,1549170
36881,12,55,3,47,57,174
20473,585,19267,269,251,4041,24413
37186,183,410,47,136,519,1295
4149,105,1425,63,86,901,2580
43615,1,6,0,6,10,23
33083,9,63,4,59,43,178
35594,45,75,19,50,499,688
43521,4,132,2,9,26,173
41389,56054,350910,14212,15320,114472,550968
9770,39,417,14,82,227,779
31617,142,909,89,80,3435,4655
1192,483,24516,275,206,9828,35308
26251,7,35,3,39,44,128
37939,599,1202,249,194,727,2971
2675,59,5453,40,104,592,6248
37742,16,1275,7,32,171,1501
13303,80,275,45,91,1287,1778
35800,11,547,11,24,137,730
3543,174,1225,93,135,685,2312
49894,1,0,0,0,2991,2992
5930,22,128,11,44,251,456
33580,8,112,3,25,37,185
31173,12794,228989,7266,4388,56569,310006
3196,97,947,57,151,1125,2377
4138,36,2277,24,66,383,2786
7573,407,2570,218,247,1271,4713
2841,758,6603,372,335,2466,10534
2139,211,1044,149,151,1115,2670
18365,34,330,38,115,378,895
2978,450,4653,281,276,3464,9124
37614,15444,95888,6724,9078,59451,186585
29355,5,151,3,27,41,227
35427,5175,31326,2792,6580,22662,68535
1172,1233,38542,1133,693,9077,50678
29427,72,0,25,73,173,343
18061,26,339,16,96,360,837
37360,558,3775,273,231,1449,6286
29067,5355,145209,2403,1554,23880,178401
216,75,1575,58,69,865,2642
38757,7,152,2,12,54,227
41652,4,55,2,3,15,79
36069,7,190,1,18,38,254
31573,373,1711,282,746,1143,4255
49429,2,56,0,5,13,76
40606,8,226,1,25,90,350
42762,2,90,3,5,16,116
3918,1723,17050,854,649,4709,24985
3398,68,911,36,69,864,1948
49398,329,0,23,48,371,771
17161,20,259,10,62,163,514
41197,2,84,3,6,31,126
2657,42,3429,41,104,554,4170
43878,158,718,60,49,907,1892
3540,82,702,55,86,299,1224
48775,2341,5981,492,665,12572,22051
43520,0,11,1,5,11,28
33606,344,15628,196,156,3239,19563
18303,12,62,2,48,67,191
17004,12,93,5,65,83,258
34304,70,668,31,79,702,1550
40562,4,118,2,13,25,162
22571,12,215,7,57,120,411
44178,0,4,0,8,17,29
23609,11,99,5,54,82,251
14837,1413,176416,381,345,7748,186303
32735,173,2749,77,110,2499,5608
38959,12033,61237,5024,6737,46024,131055
16752,7,61,1,40,59,168
10083,958,51162,559,289,12031,64999
8134,73,2008,52,78,997,3208
23707,18,107,6,53,109,293
1924,135,3502,108,102,2283,6130
36515,785,9485,348,531,8396,19545
23399,517,13887,306,199,8096,23005
30418,11,234,2,26,47,320
31144,71,2985,20,31,752,3859
37054,19,51,9,87,116,282
43253,0,8,1,8,17,34
39191,462,760,82,174,602,2080
40351,32403,0,8308,6218,12960,59889
31102,33,1135,16,47,536,1767
34243,60,680,39,50,554,1383
36652,7022,55444,3944,6289,34505,107204
7598,372,9440,209,265,6554,16840
32812,10,280,4,20,60,374
15111,20,55,7,52,100,234
36668,9,121,2,18,35,185
2986,4160,46856,4740,4844,23520,84120
33670,25,115,6,61,95,302
17991,33,195,13,55,333,629
43802,0,10,1,8,10,29
49851,1,0,0,0,483,484
33828,26,169,15,40,215,465
7475,57,1526,28,57,588,2256
14543,1745,6818,725,559,3783,13630
37266,28,2562,3,26,153,2772
30145,39,319,23,48,394,823
18525,770,5245,411,346,2199,8971
35267,762,5731,622,601,10004,17720
49032,1,39,0,4,6,50
19573,132,4173,46,52,1409,5812
30709,8103,98871,2415,1262,30730,141381
17359,20,182,17,76,211,506
1207,134,2268,84,80,2445,5011
36907,21,77,11,34,193,336
8643,107,340,53,96,902,1498
36654,1297,5121,660,1809,7113,16000
2931,756,3093,718,925,8400,13892
34077,801,4880,276,535,2390,8882
38889,6635,86246,2269,1419,33167,129736
38557,61,0,18,65,299,443
30869,607,8841,458,513,14083,24502
372,1251,88845,623,441,13790,104950
1889,18262,285878,13461,10775,107215,435591
50116,3,101,2,5,12,123
23181,10,84,21,100,89,304
1537,111,726,89,159,850,1935
24869,18,169,6,59,146,398
1577,896,8895,472,298,10291,20852
1958,78,5738,48,55,1331,7250
1650,1252,7610,1041,709,13590,24202
10934,366,14276,210,162,4467,19481
39417,4201,17151,2087,6954,17112,47505
39488,2,9,2,27,24,64
33372,1050,36815,473,598,14428,53364
49395,50,1178,21,22,391,1662
22231,32,316,20,44,261,673
38808,9,534,8,11,90,652
17012,595,3201,274,268,1846,6184
13169,167,6000,86,72,1994,8319
20541,16295,212604,8301,8001,107648,352849
834,1092,90332,642,394,13566,106026
33148,66,645,61,91,961,1824
7659,15,1159,9,48,202,1433
17599,12,69,12,58,90,241
3533,57,401,50,95,805,1408
33502,22832,202797,8965,10170,94253,339017
2926,5224,117604,3637,4755,44790,176010
23733,72,0,26,39,217,354
781,629,53059,255,283,3810,58036
5190,102,510,61,97,396,1166
24857,8,82,16,87,74,267
4486,129,1102,99,141,1188,2659
6835,28,890,8,57,170,1153
873,2378,43743,3040,3744,17385,70290
35629,3529,24801,1112,4860,12855,47157
37814,123,3929,58,90,1195,5395
9503,74,286,43,88,376,867
44276,24218,94738,4288,13501,44724,181469
44228,31,63,15,42,254,405
30028,19,127,7,73,166,392
9351,15,64,8,51,171,309
4240,136,515,142,131,1161,2085
1641,94,1312,45,48,931,2430
48040,0,6,0,10,12,28
13673,118,3397,45,57,1261,4878
43684,56,54,24,34,674,842
23781,416,4117,374,292,2608,7807
42181,2,75,1,21,32,131
45729,1,14,0,13,18,46
42071,386,1351,129,274,3912,6052
39048,42,0,23,26,30,121
35228,334,4793,151,105,5395,10778
40671,2,36,2,27,41,108
4472,1392,100538,820,575,20285,123610
37875,7,82,4,22,47,162
96,2965,42202,2733,1757,11584,61241
35488,7,44,3,44,44,142
3278,31,274,20,74,324,723
5477,28,151,15,67,257,518
45731,0,0,0,0,1211,1211
38898,5,164,1,11,27,208
1765,114,2436,54,96,1183,3883
4070,45,1138,48,76,798,2105
43264,0,10,2,8,10,30
4560,58,387,33,79,282,839
38739,67,840,42,59,1126,2134
42966,25,47,9,37,164,282
39293,3,134,3,10,22,172
20221,374,11775,208,115,4510,16982
39049,1790,16086,813,669,10955,30313
48010,0,7,1,17,15,40
2362,126,599,63,198,1237,2223
40405,147,3394,71,135,1295,5042
27573,14,801,7,55,137,1014
727,222,454,215,209,1404,2504
20009,16,107,16,82,106,327
1713,96,611,70,101,858,1736
36809,7,91,0,20,27,145
30078,6,251,4,39,61,361
22037,13,88,3,61,57,222
32879,144,3642,63,108,1723,5680
49893,1287,10525,350,60,30243,42465
17739,320,7604,166,192,3941,12223
31158,190,4059,122,103,2623,7097
48992,5,180,8,17,105,315
2669,49,4278,48,98,535,5008
42151,22,114,8,35,101,280
10765,126,4612,80,82,1530,6430
39112,520,19959,116,169,2856,23620
8563,29,148,19,59,487,742
37482,11,34,8,31,83,167
29738,20,80,8,63,102,273
36996,422,424,164,200,1335,2545
42916,3114,13674,1270,168,130627,148853
1903,51,852,34,52,575,1564
43280,0,8,2,8,11,29
36990,1596,36123,646,261,25565,64191
24465,13,61,10,54,69,207
35079,13908,81579,7433,9366,61240,173526
13423,7,196,4,31,71,309
1249,463,4723,493,538,4693,10910
25963,7,297,7,60,91,462
22613,13,151,8,42,94,308
43626,698,0,46,96,311,1151
28041,27,990,10,59,187,1273
31829,51,559,25,61,827,1523
34092,42,0,9,55,79,185
47795,93,101,38,44,933,1209
32831,246,0,111,100,159,616
440,14704,59633,11183,6041,91988,183549
28887,19,27,7,61,71,185
30152,10,127,9,59,96,301
5933,35,392,23,59,414,923
2019,87,1117,69,61,1414,2748
49515,7615,0,529,957,5472,14573
38502,7,116,1,9,25,158
1667,94,705,75,165,901,1940
49598,15,0,5,19,78,117
16590,17,114,5,57,160,353
2716,113,644,98,147,846,1848
6890,99,1388,56,69,948,2560
49614,1,86,2,7,45,141
7333,60,1193,40,58,723,2074
30060,12,61,5,54,71,203
34651,15,122,2,32,64,235
38993,15853,172983,5980,4042,66122,264980
44543,14,46,6,26,49,141
7156,53,773,25,54,559,1464
23333,10194,83274,7028,20123,33472,154091
29746,12,49,3,63,71,198
42938,31839,164035,4230,2673,115095,317872
37679,23,875,14,37,192,1141
3653,2226,21553,1866,3636,11320,40601
35156,33,295,10,65,288,691
2535,79,1231,70,138,1155,2673
43203,0,4,2,11,11,28
21013,791,1976,536,1537,3002,7842
813,41535,922245,23173,27942,53325,1068220
6844,12,845,6,43,113,1019
4067,120,438,81,145,1471,2255
45782,781,1796,177,216,1446,4416
2123,207,15643,185,229,3144,19408
40085,854,2799,388,1770,4373,10184
48553,48842,1,1611,3277,41996,95727
1508,409,2399,385,630,4173,7996
42903,3,70,3,9,17,102
33273,11,186,2,33,94,326
50113,1,46,0,1,5,53
5983,567,2314,497,838,1456,5672
40553,2,34,3,29,22,90
36343,268,1334,164,133,3870,5769
2874,102,928,58,102,456,1646
36699,0,0,0,0,3244,3244
310,47,880,53,172,535,1687
807,491,32528,431,232,9829,43511
36704,9093,94027,5223,3965,42957,155265
9100,135,821,95,99,1644,2794
12613,17,59,4,46,77,203
12483,45,859,25,71,412,1412
34423,9,142,0,18,52,221
32630,15,81,8,67,78,249
49915,1104,503,248,89,4939,6883
40787,8778,143370,2070,383,107774,262375
46142,1,4,0,10,19,34
2935,151,1371,102,128,747,2499
2491,49,1193,45,85,789,2161
6856,8,933,4,36,157,1138
16506,15,256,3,39,136,449
44193,381,2230,137,145,492,3385
37734,1,101,0,8,29,139
8972,32,857,31,51,488,1459
42784,70,108,23,51,134,386
39597,32782,465306,7544,7650,90240,603522
17657,9,60,12,39,148,268
39034,5,29,2,33,57,126
34620,15242,44565,5813,13563,47862,127045
42296,14,47,13,32,427,533
18849,468,22123,280,163,7903,30937
35182,202,4061,90,170,3544,8067
2027,55,1085,42,46,660,1888
10348,331,5512,203,401,1299,7746
36400,7,109,0,21,26,163
37560,26,32,7,106,219,390
44775,2,74,2,10,27,115
49040,5006,0,397,349,10244,15996
3078,108,1050,78,116,588,1940
11915,26,2055,12,68,246,2407
4819,84,494,51,98,356,1083
13325,1097,4179,436,380,1813,7905
8939,43,4307,20,47,810,5227
34688,14,62,3,22,102,203
1625,78,1574,55,66,939,2712
23639,17,205,5,53,98,378
33343,8,74,3,53,57,195
780,477,51414,216,250,3415,55772
42082,109,239,26,82,163,619
30760,8,83,2,32,47,172
27,8426,92598,9247,9865,49695,169831
35029,1712,3159,618,430,2164,8083
4856,57,622,25,43,502,1249
38813,7,199,2,15,43,266
48050,0,5,0,8,12,25
19287,69,2062,43,83,568,2825
36608,25,753,6,18,191,993
33692,16,581,3,35,113,748
2559,1765,19264,1097,775,20290,43191
43208,1,32,2,6,14,55
39096,2,174,1,20,24,221
36596,25,738,11,19,186,979
51086,0,5,1,4,14,24
50043,0,45,1,3,7,56
47960,0,6,0,11,11,28
49119,1,0,0,0,573,574
37908,59,580,28,54,610,1331
37688,6,74,1,16,20,117
37254,3364,10645,1328,4097,15406,34840
36181,9,440,5,19,66,539
39284,11,432,5,21,123,592
42042,4,73,1,20,30,128
46698,1,5,0,9,18,33
7296,8,532,3,27,110,680
5399,123,775,72,109,607,1686
4557,69,361,58,91,417,996
1673,55,959,51,126,517,1708
22639,10,124,5,40,94,273
40496,46974,418027,7896,14370,80473,567740
9348,36,769,32,74,569,1480
38860,771,2393,309,993,6691,11157
169,5956,83215,4076,4542,53154,150943
35122,935,9202,504,599,11551,22791
5303,41,269,24,76,395,805
16788,18,94,10,52,151,325
16824,7,57,3,49,66,182
39663,26,56,10,53,312,457
3435,59,427,47,118,584,1235
4250,37,863,12,57,272,1241
39759,3,15,3,30,33,84
23201,1329,13721,1029,1204,8829,26112
8532,407,21266,201,184,5369,27427
29935,59,198,22,67,425,771
14237,2316,15857,1651,4169,11434,35427
36252,0,0,0,0,1996,1996
34289,1718,5410,784,3385,7547,18844
3913,141,1088,84,75,1328,2716
532,4443,100269,2963,1873,19604,129152
7745,182,3859,113,99,2335,6588
31566,81,2068,49,101,945,3244
28439,74,2661,20,39,558,3352
9856,33,85,16,66,204,404
5675,2873,19445,2677,4256,13902,43153
12015,333,13714,185,150,7987,22369
23099,61,2132,36,78,675,2982
50434,461,0,157,61,552,1231
41112,3,20,2,30,26,81
330,4674,105589,3448,4629,32485,150825
19101,687,3598,356,262,1630,6533
10161,14501,241263,9185,11747,113093,389789
38525,14,145,7,58,54,278
38521,27,349,12,27,195,610
39738,70,1262,33,96,918,2379
1601,2057,11071,2116,2441,24125,41810
49004,3,120,1,4,26,154
34542,32088,318855,13199,18392,160338,542872
38341,18,199,8,27,222,474
23865,12,76,3,51,131,273
3569,188,1053,112,123,888,2364
40087,3,26,3,26,43,101
33077,14,43,2,48,81,188
29511,389,7088,145,169,4215,12006
6918,1189,13906,871,2446,6063,24475
1293,7968,12119,6369,4212,37381,68049
32254,14,90,3,36,68,211
29497,7,69,6,43,49,174
25805,305,39355,202,212,4089,44163
38895,280,3637,143,102,2028,6190
40188,10,26,7,20,31,94
40376,32,75,4,46,136,293
9789,33,456,13,45,392,939
13785,1018,5642,531,417,3268,10876
42514,526,1449,197,352,599,3123
141,445,5033,498,735,3852,10563
37187,29,55,7,33,209,333
35006,103,6398,57,80,1701,8339
8792,86,8134,40,40,851,9151
2467,93,1274,102,260,569,2298
2215,392,2300,417,502,2653,6264
40352,42,453,16,26,296,833
39136,5,23,1,29,31,89
18677,15666,162044,7887,12197,74356,272150
17655,135,2561,91,114,1694,4595
31695,4,307,2,26,34,373
30647,42,240,11,39,439,771
13103,18,45,8,52,235,358
25087,36,438,23,66,330,893
27789,23,839,10,30,171,1073
40717,55,10,11,18,1065,1159
2004,642,4379,560,557,7287,13425
36281,8,226,0,24,51,309
4053,665,26987,380,347,4868,33247
43464,0,4,2,6,11,23
36103,9,150,1,11,32,203
43013,370,2880,191,140,808,4389
5935,33,275,33,105,350,796
43043,3,80,3,5,19,110
2054,40,604,29,64,651,1388
32310,9,92,3,34,48,186
13677,574,21661,541,567,12164,35507
23311,10517,58612,6497,9935,48335,133896
11531,601,25223,329,225,9096,35474
43242,0,14,2,6,11,33
39179,10,208,1,14,59,292
9055,1582,17352,990,853,19134,39911
29995,16,1416,8,35,151,1626
33149,97,780,72,103,1200,2252
26265,10,58,8,47,91,214
40691,26,478,8,25,243,780
38921,285,13650,154,95,6231,20415
39435,3,27,4,37,68,139
3824,113,698,67,93,445,1416
3786,3597,107915,1140,366,160406,273424
34777,669,35256,396,235,9655,46211
36932,105,2871,50,106,833,3965
14267,404,6991,255,230,9682,17562
50521,154,0,11,26,121,312
15117,1882,106210,857,469,16929,126347
28367,29,290,17,59,339,734
308,867,4145,867,926,11704,18509
10276,63,2844,67,93,1093,4160
8369,75,4162,42,112,636,5027
1492,700,4632,612,678,5550,12172
37029,1920,13806,559,355,8434,25074
1013,3054,15393,3502,3385,29052,54386
37147,6,356,4,16,48,430
4058,52,931,40,51,735,1809
50709,2,0,0,0,2030,2032
36380,7,38,4,41,34,124
39668,163,160,64,171,1540,2098
13595,965,6353,452,381,2620,10771
7436,67,940,52,69,877,2005
263,39289,260743,23340,11595,129333,464300
17651,3061,22594,2410,4927,17828,50820
35085,6,17,1,38,31,93
1972,636,4107,619,465,4090,9917
24629,5261,30288,4099,7448,27430,74526
30582,11,62,5,63,60,201
50696,352,6565,82,77,2201,9277
9536,22,96,8,62,100,288
2368,148,928,79,120,492,1767
24429,56,5452,27,75,679,6289
509,1017,24321,1008,1510,7785,35641
30015,38888,616413,18519,17776,192075,883671
36299,6,76,2,23,26,133
31634,40,5086,15,66,308,5515
11699,70,1698,39,55,701,2563
431,11825,969887,2908,1163,100511,1086294
708,304,2735,255,279,3507,7080
8140,40,790,44,119,206,1199
21775,201,1213,60,77,1342,2893
30759,7,31,2,44,43,127
4084,183,925,111,144,936,2299
30427,7,308,1,20,36,372
43994,1,22,0,19,22,64
28151,37,276,14,41,266,634
43276,0,4,2,11,9,26
10191,1570,11291,1190,1374,12762,28187
37221,5031,24881,2455,5654,25165,63186
1668,637,38133,651,1296,3136,43853
38924,14345,57720,6471,11598,55606,145740
9989,42709,1070179,23115,17030,269319,1422352
33027,589,2081,330,1021,4168,8189
40794,5,98,3,5,20,131
29541,10,94,7,47,73,231
36371,570,11094,186,158,6971,18979
50124,1,31,0,1,5,38
4127,506,2294,226,200,1265,4491
40967,29,872,9,26,210,1146
1466,217,1062,187,195,2129,3790
40346,3,117,3,11,29,163
48953,79,966,31,42,955,2073
27375,18,72,11,75,182,358
34850,8,26,4,33,109,180
13939,2939,83682,1539,1014,17659,106833
406,471,8123,424,838,3968,13824
43741,621,1349,157,579,1656,4362
28485,6,43,2,38,46,135
9078,55,277,25,64,602,1023
6670,36,403,32,78,859,1408
7420,18,143,8,55,202,426
50512,2,51,1,1,8,63
50000,1,50,0,5,9,65
42703,10,465,5,8,73,561
33911,27,837,19,68,374,1325
8355,17,134,13,87,162,413
43517,3,40,3,13,16,75
17489,13,117,4,46,104,284
31149,1392,38551,566,325,20393,61227
31280,466,7716,254,211,8425,17072
36055,8,96,3,32,32,171
48914,10,17,1,8,204,240
38862,3,34,4,31,40,112
268,10595,210696,5339,4730,75925,307285
42522,63,59,24,65,205,416
8546,42,791,29,61,546,1469
38119,3,97,3,48,37,188
14657,530,4058,276,251,1483,6598
25291,24,827,14,59,485,1409
38313,424,10685,219,115,8362,19805
31909,120,6659,71,58,1432,8340
42954,2,57,2,7,24,92
43261,0,7,2,7,11,27
38935,7366,51450,2174,4615,33183,98788
13917,167,1111,103,149,817,2347
1060,2898,21702,2203,2145,17154,46102
18177,295,13443,148,159,3785,17830
22057,400,17750,203,129,5637,24119
5567,56,269,37,70,245,677
37864,186,3602,85,123,1620,5616
16335,202,5454,90,130,1999,7875
1297,90,3393,61,53,1184,4781
32421,7,209,6,58,49,329
36135,111,169,57,188,1179,1704
933,1003,14719,635,806,12618,29781
4009,224,1010,129,128,858,2349
31668,94,2427,83,90,1351,4045
413,786,48552,284,985,10359,60966
32609,27,181,8,43,246,505
26315,8,28,3,44,58,141
49721,49887,0,1253,553,51027,102720
24823,120,4777,40,101,1325,6363
43793,886,2870,291,235,1066,5348
25461,17,403,4,32,102,558
41545,52,223,21,38,370,704
4852,156,766,95,116,691,1824
1604,49832,255522,38990,38722,127828,510894
27927,825,6687,409,1411,5307,14639
3211,148,1184,97,151,980,2560
23725,1060,12797,505,275,8252,22889
40475,11,188,0,16,69,284
6927,529,19214,427,366,11416,31952
8965,30,692,20,61,465,1268
3307,267,3326,186,171,1150,5100
13057,1086,5655,517,462,2657,10377
38867,5,36,4,31,115,191
37393,10965,96238,3257,7989,29021,147470
8697,8,356,5,27,70,466
43320,0,5,0,7,14,26
9361,23,1321,9,35,235,1623
2724,263,14067,123,138,3311,17902
38032,692,1960,246,215,973,4086
25641,29,1099,14,32,279,1453
17469,31,116,10,48,152,357
1867,67,749,28,48,832,1724
3501,224,1886,200,178,2291,4779
29111,28,175,22,62,148,435
8500,70,690,32,52,971,1815
23401,23,300,10,36,225,594
31465,9,71,1,34,41,156
1285,320,8960,154,139,4805,14378
34676,9,88,7,60,38,202
5194,889,7923,525,422,3107,12866
8192,17,60,8,37,116,238
1531,487,24489,390,208,7901,33475
7985,54,405,19,59,345,882
39766,15,146,3,9,83,256
44807,2763,31480,706,179,40182,75310
3615,1764,18650,1523,2249,11064,35250
970,259,2446,283,294,2184,5466
29792,6,166,7,41,62,282
32595,9381,43109,3907,14779,21496,92672
28965,10,51,3,48,68,180
1852,3316,29419,3252,3026,32330,71343
18817,8,81,6,61,94,250
35494,7,113,7,40,122,289
48988,3,49,1,21,36,110
19209,10,260,12,36,149,467
38920,2413,8778,844,2787,10498,25320
4094,427,20461,239,301,5466,26894
10301,154,2862,93,96,1766,4971
40506,2621,1830,831,2958,4211,12451
30379,526,12940,340,229,7991,22026
22465,41,100,20,92,339,592
9065,3197,52944,2002,1873,20661,80677
4086,63,1615,74,178,411,2341
26007,9,161,2,39,52,263
18637,28,402,23,75,406,934
45677,8,0,6,23,31,68
9494,111,1129,48,111,1453,2852
29381,8,40,5,45,53,151
45688,1,5,0,11,20,37
30375,2586,20587,1440,3014,14646,42273
45645,2,41,5,25,56,129
29823,42,303,29,69,379,822
29529,13,66,7,67,132,285
33491,207,2920,114,104,2712,6057
11787,93,1290,83,107,1419,2992
32862,10,132,1,13,44,200
3012,256,3852,221,419,1037,5785
18325,14,97,2,50,87,250
20583,106220,1253104,43677,33212,196460,1632673
1833,56,803,23,56,571,1509
30346,4071,154491,1206,1323,59410,220501
8132,54,986,49,150,836,2075
24745,528,2412,277,219,1422,4858
2014,365,5252,295,223,3289,9424
32011,371,2757,230,300,2214,5872
35465,70,595,32,69,644,1410
35667,9,239,1,28,56,333
36180,6,237,1,13,42,299
903,775,108466,364,293,5859,115757
21075,170,6127,115,117,3002,9531
29615,9,843,6,34,103,995
13439,67,671,41,81,948,1808
50028,0,66,1,9,7,83
50204,21152,0,771,2592,17292,41807
10594,26,256,12,67,241,602
2084,187,1006,141,173,1391,2898
9487,676,3887,380,294,2330,7567
33860,10,129,1,26,51,217
43252,0,12,0,10,11,33
3896,376,3280,215,187,1159,5217
21743,6943,54787,4607,6404,43319,116060
41488,33688,116126,6771,9414,83154,249153
171,207,1703,180,240,2434,4764
35452,10,50,3,34,51,148
39315,34,289,16,39,262,640
42009,1,73,3,9,20,106
3643,47,443,29,77,293,889
2806,66,348,69,141,575,1199
40880,289,289,65,154,903,1700
4304,662,4744,373,549,3255,9583
37584,1789,4910,806,3174,11129,21808
49138,110,668,89,37,3576,4480
30909,12,642,0,31,87,772
2067,70,2709,59,54,1190,4082
9365,46,389,24,57,429,945
43810,0,6,1,7,13,27
34342,7,17,4,28,40,96
5762,2290,13026,1045,943,5529,22833
31002,6,26,4,48,51,135
9940,50,896,24,53,651,1674
3465,51,283,29,54,610,1027
261,489,8919,361,370,3766,13905
20115,24,132,11,84,213,464
40438,617,1258,237,469,2490,5071
35072,384,8822,186,244,3717,13353
49054,11,135,2,4,36,188
2829,597,10431,415,365,6192,18000
31404,30294,303630,12966,23396,88940,459226
1365,1182,59825,413,503,6094,68017
43215,2,22,2,10,15,51
1071,84,1511,75,57,1109,2836
37139,503,9091,219,105,6547,16465
29377,14,299,6,37,91,447
189,8538,162989,7774,12427,53253,244981
35220,8050,26131,3642,7034,17287,62144
40001,19,405,2,23,100,549
400,6865,70498,5673,3375,52016,138427
2695,180,4558,134,142,3096,8110
2531,383,3813,213,223,1337,5969
4183,57,340,46,107,482,1032
2692,121,1616,97,119,1073,3026
50533,1,25,0,4,4,34
3349,1015,7333,799,1155,6568,16870
4597,52,304,38,94,403,891
1070,522,1939,652,644,4079,7836
50403,0,0,0,0,833,833
11095,13,103,3,57,98,274
31994,1240,24226,525,639,6627,33257
35172,7,47,2,56,38,150
11069,81,3753,98,131,1665,5728
4535,3108,40148,2066,2539,21735,69596
36313,7,17,2,37,55,118
12221,105,3333,65,105,1390,4998
2729,86,3047,55,76,1528,4792
40513,6770,28827,2805,5541,29089,73032
32553,1501,68661,849,410,14213,85634
35493,5,34,7,56,43,145
7144,115,1769,76,83,1799,3842
175,1455,14159,1404,1849,8309,27176
3054,104,1038,92,160,884,2278
30230,9826,82686,4142,2370,20191,119215
5600,33,274,21,84,220,632
50307,4,1,5,1,75850,75861
19369,15920,211209,8009,10008,74678,319824
21277,13,119,7,59,89,287
4282,4008,152036,1849,787,55465,214145
30176,9,107,6,69,86,277
18483,38,274,24,97,249,682
233,1502,12202,1944,1609,5309,22566
5256,104,8216,114,139,2064,10637
26443,10003,75239,4542,10778,40985,141547
37585,5229,66923,994,1601,13347,88094
5515,30,257,16,61,224,588
42947,248,451,70,107,707,1583
48254,1,7,0,13,21,42
31078,14,40,5,80,87,226
37086,32268,480966,13408,15562,92437,634641
41278,5,160,0,11,29,205
43016,28,148,22,26,108,332
33740,287,4945,115,126,3692,9165
28347,13,279,6,31,111,440
15199,1447,69156,883,529,30394,102409
5466,41,478,37,38,869,1463
24679,18,198,10,69,196,491
37739,249,1266,114,256,557,2442
1575,89883,1455715,51834,37937,297419,1932788
49348,81,346,29,52,731,1239
4699,156,1422,107,126,749,2560
39436,3,20,5,33,55,116
4726,2343,49637,1748,1645,15000,70373
48874,0,0,0,0,132,132
39990,3877,5220,1385,3927,14931,29340
5237,35,520,35,44,381,1015
38703,8,142,1,13,112,276
23909,12,192,4,44,97,349
18133,39,484,7,83,156,769
14349,5473,220399,2085,1733,59783,289473
45599,145,833,25,66,288,1357
4056,98,1604,71,115,764,2652
35063,124,1340,80,82,1369,2995
2575,26,588,29,118,168,929
186,4155,143913,1645,951,20525,171189
32934,45,1395,21,61,482,2004
45517,1,12,0,15,19,47
10262,19,598,13,30,245,905
210,21584,109969,25094,19196,46405,222248
39936,11,171,11,44,127,364
42831,221,884,129,140,1552,2926
49665,1,0,0,0,6046,6047
33295,0,0,0,1,2621,2622
9253,140618,1367346,76244,44976,544554,2173738
35968,56067,512759,19618,16128,172846,777418
3728,457,3060,273,245,1740,5775
2470,140,2679,84,89,1982,4974
38760,178,1710,116,104,609,2717
32717,2444,5017,1074,1462,6950,16947
40571,34941,155206,10390,12938,93465,306940
37694,6,67,3,15,23,114
12919,24,1036,9,33,285,1387
17441,13,120,12,80,161,386
37806,11831,69248,4738,17820,26242,129879
41183,9,167,2,17,50,245
27815,959,8753,551,1065,2684,14012
36993,64,656,40,123,302,1185
20945,126,3209,87,180,516,4118
3772,114,3007,116,534,352,4123
3811,89,625,105,155,724,1698
31221,997,6580,630,2020,3404,13631
1969,151,6667,134,146,2951,10049
39153,3,36,4,22,55,120
2287,210,2383,249,611,1041,4494
324,2232,10059,1768,1092,16915,32066
43597,0,23,0,6,10,39
26135,14,94,10,78,195,391
3571,118,1788,128,247,1229,3510
19703,10272,57459,6912,4672,88250,167565
45445,13,33,8,21,56,131
41504,6,75,3,33,57,174
51065,1,0,0,0,59,60
31641,13,383,4,21,75,496
39001,8,504,7,14,82,615
3136,74,1686,98,168,597,2623
24475,2117,35765,1395,584,8606,48467
34847,51,0,26,57,134,268
3878,82,590,76,137,883,1768
49981,1,0,1,0,22391,22393
39545,1012,16645,381,271,16416,34725
8424,8500,154713,4680,7857,45079,220829
33777,20,572,6,29,165,792
26149,8,45,2,50,41,146
874,4117,153401,4070,4490,12438,178516
37268,1056,3229,380,1471,6089,12225
42956,51,188,15,49,285,588
849,33099,535810,26926,22615,212106,830556
3828,16,83,10,58,145,312
31552,920,30754,586,260,15628,48148
7135,716,9128,367,244,9023,19478
3381,120,1793,87,75,1774,3849
9781,38,161,21,83,319,622
2412,277,2631,149,170,1025,4252
1614,1273,42566,911,1369,3959,50078
6872,71,1505,62,121,1224,2983
45812,2,5,0,11,20,38
1482,57985,281765,57867,45746,186943,630306
39905,0,0,0,0,3867,3867
41445,3,199,5,6,25,238
33360,234,3488,279,261,3593,7855
41514,3,1,2,1,82581,82588
5667,3909,131504,1801,1339,21473,160026
31789,1322,8775,548,363,3275,14283
5088,38,256,31,102,298,725
34353,15,82,9,61,86,253
41794,374,2371,160,183,845,3933
8829,44,153,27,107,211,542
3509,112,1886,39,55,1263,3355
23251,10508,94266,7185,8484,47648,168091
973,528,3842,538,834,5408,11150
34674,21,50,13,24,295,403
2667,50,3564,76,98,571,4359
44776,2,101,2,9,37,151
46821,207,199,38,88,305,837
38112,75,148,38,54,374,689
33927,9,122,2,36,54,223
38167,3,27,4,19,32,85
2186,156,1041,98,128,788,2211
10308,2730,21200,1637,2724,14659,42950
46293,1,3,0,11,20,35
5958,17245,300819,10344,16451,90584,435443
2941,30,927,19,61,317,1354
42749,3,60,2,5,15,85
44171,1,4,0,7,14,26
18321,8,59,1,40,57,165
12139,33,124,38,95,378,668
8624,1963,29130,1962,3826,7096,43977
36923,1648,40062,515,662,17329,60216
42466,3,24,2,19,42,90
30154,52,0,21,64,89,226
37287,456,2134,184,199,816,3789
6074,22,231,14,91,247,605
29107,7,276,4,34,54,375
1105,116,3535,83,110,2123,5967
1589,4352,27637,4548,4980,38512,80029
10695,916,4792,425,357,2761,9251
3396,79,692,54,89,423,1337
28227,241,3164,138,125,2849,6517
3226,1346,49834,638,566,6993,59377
9706,191,3410,193,147,3880,7821
2495,194,2263,215,358,2066,5096
35697,50,0,15,83,95,243
39065,46,3199,9,31,410,3695
43779,776,2330,199,310,3352,6967
31759,14,530,4,26,74,648
49117,3,80,1,5,28,117
547,75,1618,83,78,903,2757
7113,106,4859,54,135,1278,6432
29785,14325,145571,6445,10910,56706,233957
43655,0,7,1,6,11,25
8832,17,126,16,83,138,380
2594,1525,33667,792,696,24664,61344
30077,7,237,1,28,39,312
5037,59,1400,56,64,1112,2691
42998,8,14,6,60,63,151
42257,4,100,1,13,59,177
39253,2,12,1,31,25,71
45683,1,5,0,8,19,33
30042,20,213,14,42,219,508
17092,32,281,21,84,298,716
2317,218,2614,89,161,1930,5012
1046,329,8236,333,269,2739,11906
19151,8328,63866,4360,10026,37480,124060
1356,979,15183,756,483,9853,27254
32956,175,0,61,175,234,645
35752,113,2920,38,65,1073,4209
6119,129,340,103,175,1114,1861
35254,170,482,72,236,728,1688
48441,0,0,0,0,1429,1429
1559,14507,183396,8749,7503,57803,271958
36498,184,1543,143,151,2308,4329
2503,47,203,38,101,466,855
36132,10,141,9,53,94,307
30140,11,64,2,70,47,194
35130,7,18,1,40,38,104
42351,37864,102313,3991,3887,71701,219756
36752,17,270,5,15,100,407
33144,45,199,28,44,553,869
40375,27,402,5,34,128,596
11747,681,3476,364,264,1966,6751
48707,5530,51378,821,436,30057,88222
1128,312,5781,239,208,2384,8924
2269,210,6596,169,207,2761,9943
40610,1627,2191,654,703,3494,8669
1374,984,11052,841,938,6376,20191
7786,46,766,34,86,535,1467
29739,13,230,12,53,149,457
637,541,11800,361,530,4436,17668
30214,17,511,5,53,149,735
13679,128,2898,129,238,1050,4443
39235,821,29558,337,438,14859,46013
34629,16,111,3,28,78,236
4813,216,902,120,183,1248,2669
10224,51,272,40,110,447,920
36522,3020,21869,1063,1041,12511,39504
3975,45,160,30,112,261,608
37133,16,63,5,20,107,211
36009,1630,7429,884,4353,7072,21368
47616,2166,28182,428,1557,10222,42555
43762,52,43,38,23,2956,3112
35160,5,45,3,39,42,134
17088,10,225,9,99,131,474
37891,5,29,3,38,23,98
5936,37,424,29,47,593,1130
36950,11665,21677,3125,1641,12358,50466
38249,3506,143555,805,533,23827,172226
28447,374,10061,173,242,4009,14859
30326,11,276,6,45,60,398
40237,9,177,1,19,62,268
36248,16,103,4,32,104,259
83,176,8931,149,156,2930,12342
33041,1606,14625,865,1419,6174,24689
31156,516,15216,229,177,6159,22297
24405,46968,124927,24621,30764,123957,351237
34708,10,101,2,30,44,187
33861,9,114,1,31,53,208
323,18006,160457,13195,9414,147560,348632
37543,7,167,2,23,56,255
39870,3,77,0,11,18,109
41531,305,2728,155,140,2970,6298
2091,31,508,17,42,353,951
13767,6512,33355,1394,739,8268,50268
11767,34,147,21,40,632,874
49992,4,12,0,11,19,46
32844,11,197,3,19,51,281
43359,0,8,1,6,11,26
8523,47,252,27,76,218,620
40410,9,557,9,9,129,713
1777,150,2754,72,64,2255,5295
17891,6,158,2,31,77,274
319,150,3780,136,170,1640,5876
4773,126,603,77,134,1163,2103
4332,35,297,34,95,354,815
33758,501,1912,128,235,1562,4338
3137,209,2080,191,301,1331,4112
13819,16,112,12,67,120,327
25897,384,6313,199,218,4127,11241
40080,1551,26164,386,278,11427,39806
8249,92,1672,40,62,1059,2925
40076,576,6039,231,158,6500,13504
10135,30,221,21,94,162,528
41156,5,33,3,23,35,99
33720,183,2860,124,143,2533,5843
15927,468,24394,279,159,5542,30842
546,438,5151,369,461,4363,10782
48727,1335,3641,371,177,3916,9440
36999,6011,108249,2219,696,73432,190607
38256,12737,50450,5677,9618,55577,134059
20725,11,285,2,20,58,376
37873,1172,12557,405,413,4201,18748
2779,66,1000,42,75,757,1940
29741,12,34,3,30,65,144
49971,0,5,0,10,16,31
43411,0,13,2,5,8,28
19769,13435,139808,6779,15575,53812,229409
40765,7,74,2,23,87,193
36684,46,1034,19,57,436,1592
563,1320,24711,1197,1685,10507,39420
38019,115,170,45,91,1049,1470
15527,32,490,28,61,178,789
5955,988,37063,723,529,11093,50396
21717,7,249,3,27,50,336
42263,2,12,1,17,32,64
9645,466,1731,266,172,3663,6298
23479,647,21913,338,357,2134,25389
17747,639,4303,329,338,1809,7418
48339,4,16,1,13,23,57
10534,166,8693,66,176,881,9982
39137,2,21,1,27,30,81
6234,185,6723,137,123,3078,10246
3182,84,828,55,79,962,2008
7257,34,836,13,61,463,1407
37860,145,2250,161,125,2990,5671
32369,12,46,4,52,87,201
42057,195,1135,53,79,1219,2681
40056,25549,128570,9441,17907,77759,259226
33197,3674,24582,1978,3673,19136,53043
48057,1,5,0,8,16,30
5391,1144,60904,259,1442,2946,66695
1931,112,3625,98,108,1677,5620
2733,58,1656,67,73,1150,3004
10435,32,308,19,53,462,874
37174,75,877,22,36,674,1684
48675,3,0,2,1,53055,53061
35166,7,46,2,44,35,134
9731,268,10396,149,226,2221,13260
35704,15,246,7,58,130,456
30955,22,467,3,45,127,664
20449,1110,60324,555,472,18506,80967
16730,20,161,4,63,160,408
9087,49,700,44,108,803,1704
10859,58,1249,16,39,479,1841
39857,5,78,0,9,16,108
50431,0,0,0,0,159,159
2458,213,4296,168,134,1987,6798
39864,755,803,329,170,2182,4239
50237,270,1902,114,95,835,3216
36118,20,59,11,42,197,329
33104,331,3264,162,166,1441,5364
2045,44,537,28,65,605,1279
36072,5,140,1,10,30,186
38923,94,507,23,69,251,944
13177,40,144,20,78,204,486
23679,66,1133,73,74,903,2249
918,177960,278277,105119,46416,311341,919113
2944,248,1664,143,167,1422,3644
16397,7278,50306,3885,9356,38913,109738
424,1902,6673,1324,866,14932,25697
30777,36,140,17,108,232,533
10073,4860,80455,3256,5663,30653,124887
42894,780,7675,294,98,17164,26011
39156,1,18,2,27,35,83
2262,106,3399,51,84,1231,4871
13517,619,5811,280,224,6234,13168
36621,14,172,1,21,72,280
264,1933,94493,595,438,15033,112492
37451,20752,58055,13040,23326,85277,200450
3478,621,4323,338,277,2045,7604
42111,3,58,1,16,38,116
968,207,1049,136,142,1801,3335
395,2365,118023,1582,1979,24534,148483
49355,12,10,8,15,115,160
16381,104,2639,62,74,1711,4590
34764,42,153,21,64,394,674
17391,741,12162,775,287,3139,17104
11661,80,1043,19,74,682,1898
5158,42,4055,24,43,628,4792
23315,11,92,4,57,74,238
49913,29,842,13,20,203,1107
565,1274,48295,628,384,22898,73479
39546,20,0,6,30,47,103
29758,21236,135200,9022,32125,56459,254042
12185,12,61,7,52,80,212
1776,32,679,13,42,344,1110
39033,4,22,3,31,33,93
31685,13,908,6,47,97,1071
32409,1004,19965,481,355,7727,29532
5522,169,1041,111,117,688,2126
64,6184,120113,6307,8343,48405,189352
17731,584,6076,550,747,2446,10403
36273,5,13,2,37,31,88
48965,0,0,0,0,155,155
1179,384,2043,351,304,3433,6515
36895,722,4332,368,319,1530,7271
756,557,24850,421,476,8331,34635
12189,88572,636692,63313,48151,340919,1177647
36767,7,151,1,7,28,194
1138,1991,38342,2377,3225,6963,52898
31445,0,0,0,0,856,856
43751,37,2156,19,59,521,2792
36575,14,127,4,20,79,244
25193,6,47,5,50,52,160
32779,5,313,3,27,44,392
1222,9929,116450,9078,13402,66677,215536
32916,23,74,2,62,62,223
50444,131,0,6,11,96,244
36156,66,2023,18,42,530,2679
460,746,68994,422,275,7943,78380
30331,9,285,4,32,62,392
39811,2850,18865,1179,2411,16651,41956
10516,86,2726,39,53,1268,4172
7488,11,549,7,30,101,698
38603,62,43,16,45,206,372
8660,7,169,5,38,66,285
42496,341,5243,78,115,1143,6920
29459,9,182,1,32,32,256
14145,602,8300,248,298,4961,14409
45607,2,72,1,14,37,126
48645,36,34,16,28,176,290
39684,10,509,6,14,127,666
40732,91,157,18,43,572,881
22197,8,68,3,61,68,208
36089,8,362,2,30,54,456
33348,22,97,5,36,154,314
16468,416,19441,294,196,4873,25220
34928,25,96,11,135,160,427
8726,2910,23946,2031,2565,24473,55925
37164,420,5501,86,191,1163,7361
174,8317,107475,6502,9297,41945,173536
6795,566,9754,403,192,6975,17890
9760,4259,109839,1936,1000,70503,187537
48789,5,22,1,43,40,111
15307,102,3103,63,114,1222,4604
36661,35,234,15,39,409,732
16530,39,204,16,101,300,660
48044,0,4,0,11,17,32
4003,477,1850,218,208,3814,6567
2930,16,58,10,66,107,257
36674,12,129,1,20,35,197
38609,18,14,7,36,41,116
40509,2,123,2,11,30,168
27653,56,2783,33,87,587,3546
8331,138,8027,121,144,2177,10607
22473,11,200,3,34,47,295
86,1987,21057,1504,1043,9741,35332
1586,114,2010,65,106,1125,3420
31245,6504,109306,2056,1010,71544,190420
1247,142,1233,170,204,1530,3279
41497,1328,13736,548,117,32166,47895
32379,18389,174801,6300,29296,78937,307723
42786,1,81,4,6,18,110
38804,233,615,66,171,1133,2218
3056,144,1101,69,104,594,2012
28419,13,444,7,34,92,590
49873,156,149,20,24,131,480
38928,21,0,15,32,49,117
26305,10,44,3,47,50,154
48987,4,107,2,5,19,137
13675,72,4249,30,40,826,5217
38910,0,0,0,0,479,479
37153,7,109,0,28,31,175
35034,10,47,2,41,52,152
2790,59,1103,24,52,669,1907
30892,15,97,12,91,110,325
5636,45,226,20,74,390,755
7177,36,89,15,70,236,446
34363,16,75,3,45,109,248
29597,6,719,10,34,99,868
34743,10,91,3,34,57,195
30395,6,188,1,22,55,272
13513,24,1412,20,54,494,2004
6492,53,692,31,44,671,1491
11625,10,97,5,56,108,276
3146,138,679,129,154,2068,3168
8108,37,1015,28,71,639,1790
29129,386,10711,238,229,4218,15782
33156,296,3789,239,280,4507,9111
32384,27,969,15,41,247,1299
40779,50,207,23,23,510,813
6713,149,3838,142,106,2106,6341
2709,107,2383,90,226,608,3414
13165,21,53,8,76,102,260
35090,8,57,1,28,41,135
36375,5,95,2,22,37,161
33903,78,895,39,108,996,2116
45687,1,6,0,10,21,38
9558,20,173,8,44,170,415
34872,13,130,4,58,92,297
1728,1373,8002,1750,1630,5662,18417
3274,37,375,24,77,380,893
20237,18,94,11,94,179,396
13203,3648,24568,2528,1818,22720,55282
35315,699,10083,329,208,8756,20075
6727,25,155,10,75,151,416
41203,18,104,14,24,225,385
19755,48,351,36,104,183,722
1782,215,1192,119,141,973,2640
25305,13,99,5,48,176,341
35513,13,91,2,42,59,207
21755,672,10225,304,213,3818,15232
15633,1255,19104,1327,671,8354,30711
14765,8856,50571,5465,8942,29719,103553
23305,553,4098,320,242,1764,6977
42414,732,1867,269,387,3609,6864
33325,14,120,5,62,97,298
40166,431,251,126,237,2212,3257
33152,65,611,63,94,926,1759
34237,43,0,9,42,82,176
16762,3250,285979,1235,775,32849,324088
6531,423,2998,252,194,1328,5195
34480,4472,108309,1515,748,29163,144207
12875,1785,12308,1245,1475,6955,23768
9938,2878,26925,2701,3037,19359,54900
19505,23,121,20,93,244,501
2459,116,2869,79,72,1599,4735
12341,13,167,9,48,110,347
47159,74190,1,1532,2724,50945,129392
35102,67,537,26,105,929,1664
9735,847,25731,426,380,10304,37688
19695,31,107,16,65,316,535
9352,56,247,23,83,214,623
32359,79,2743,75,111,1088,4096
38663,1908,16469,696,1705,9898,30676
1879,324,4849,112,89,4217,9591
37607,6,194,3,14,49,266
50012,0,0,0,0,981,981
584,3809,32765,4260,3423,40227,84484
35382,1237,47791,506,525,21215,71274
27939,209,7188,106,139,2278,9920
3942,115,746,56,104,558,1579
6577,41,216,18,59,378,712
43463,0,8,1,5,11,25
855,6796,63137,6341,8353,42808,127435
49780,2725,0,81,404,1438,4648
37188,2913,21548,840,2021,10539,37861
30939,10,103,6,41,138,298
3837,156,907,131,181,1073,2448
48375,1466,20075,319,140,36445,58445
29517,51,843,41,67,802,1804
33571,13,117,4,54,73,261
9829,39,240,30,64,873,1246
31971,11,69,1,38,65,184
28911,33,600,30,83,574,1320
29822,33,334,37,79,335,818
33603,12,49,3,44,92,200
13179,25,107,14,71,146,363
34430,458,19971,204,217,4927,25777
23275,0,0,0,0,2234,2234
7511,33,202,25,56,219,535
38346,20,201,8,37,198,464
32298,12,504,5,24,69,614
27879,606,2437,306,261,1572,5182
37532,4,184,1,13,36,238
9203,867,27259,721,685,10414,39946
27957,1860,74462,979,546,18996,96843
34088,407,3827,182,847,1990,7253
5715,51,1222,43,57,649,2022
43806,0,10,1,5,8,24
38788,70,733,60,78,1056,1997
43400,0,6,2,6,10,24
35098,6,28,2,41,40,117
48453,3694,18741,637,969,12415,36456
30453,26,282,16,67,320,711
37641,238,606,60,105,1428,2437
40936,1725,65796,538,300,30736,99095
20385,50,638,37,72,620,1417
1163,776,2944,776,820,6745,12061
10162,16228,269282,9789,6304,141492,443095
23829,16,98,5,63,166,348
1750,297,9983,167,191,2564,13202
9445,43,272,26,43,407,791
3512,101,1961,45,61,1626,3794
512,5078,407678,1881,666,60055,475358
28819,12277,178739,4369,8828,54172,258385
34552,287,2376,176,208,1633,4680
16251,47,323,19,42,336,767
6018,17,72,7,44,124,264
33485,9,85,1,47,53,195
1937,55,870,46,50,718,1739
50056,3,85,2,3,13,106
24677,14,159,15,44,183,415
14967,13136,392891,6586,6380,64196,483189
38614,5,49,4,36,46,140
4725,9450,111669,7424,7656,85551,221750
22449,13,200,3,46,115,377
12079,1227,49255,678,892,11877,63929
36376,6,93,2,17,23,141
1683,381,2651,558,714,2313,6617
40028,307280,993598,19792,10293,158746,1489709
2194,434,2983,201,194,1607,5419
6472,69,414,41,113,1060,1697
34244,54,1563,44,83,639,2383
37101,8,85,7,64,48,212
725,66,1685,34,56,794,2635
48080,0,4,0,10,14,28
19489,2305,121500,963,518,32367,157653
46095,55814,178639,11665,8299,136761,391178
41271,63,2621,34,76,1176,3970
12921,86,3108,57,46,871,4168
48966,4,106,3,4,22,139
39476,6,289,0,9,36,340
1069,309,4058,294,332,1804,6797
34489,67,797,37,82,823,1806
23741,23,223,8,62,183,499
29083,1034,5589,496,353,2859,10331
36381,6,82,1,23,31,143
40057,12,326,6,38,197,579
25599,9,98,6,44,74,231
32015,3188,23124,1846,850,13384,42392
36675,8,121,1,17,43,190
35592,991,4024,380,342,1289,7026
23285,94,8149,48,47,1173,9511
34899,951,3361,359,296,1785,6752
17277,368,5292,426,426,6796,13308
15201,1364,59645,878,488,30194,92569
39271,7,109,6,28,81,231
28105,861,14983,745,406,7450,24445
38727,11,556,0,34,77,678
1143,264,16104,266,268,5252,22154
30981,9,47,1,41,55,153
41458,21,0,8,57,72,158
31893,16,32,7,43,105,203
883,413,17613,322,203,6810,25361
40004,14115,176349,4204,4249,46049,244966
2645,24,806,27,76,338,1271
35554,10,415,3,14,52,494
35386,9,306,3,30,49,397
88,482,18979,258,212,6592,26523
34225,9,23,2,47,44,125
11445,59,719,35,68,518,1399
11855,415,2738,243,246,1578,5220
501,725,13817,677,1129,2644,18992
3527,161,1098,71,130,583,2043
2786,264,994,159,246,1345,3008
36594,34,927,8,19,214,1202
43664,0,9,2,5,8,24
11245,35,123,24,67,203,452
3190,35,632,25,45,460,1197
44046,2,51,0,3,9,65
10950,135,2057,145,159,2654,5150
2275,311,2381,191,160,1247,4290
38476,5518,44860,1859,2141,27187,81565
35038,9,62,5,50,49,175
36666,31,247,27,67,452,824
8950,81,1099,56,99,1407,2742
36001,2929,15482,889,3486,10647,33433
2769,94,365,89,109,852,1509
69,533,3201,641,973,4603,9951
2062,68,1659,51,50,863,2691
11221,53,458,31,46,967,1555
8767,113,2044,83,80,1427,3747
38501,2,164,1,12,37,216
10479,760,11415,506,380,8388,21449
7279,171,2574,101,149,2316,5311
24883,12,161,9,46,125,353
19909,16,72,6,47,106,247
40454,46455,275774,11991,10106,107530,451856
39309,2,33,5,34,62,136
8682,14,447,5,23,131,620
31201,61,3156,66,97,667,4047
25647,885,11074,817,309,4424,17509
36605,38,802,16,15,194,1065
16822,28,479,13,60,293,873
43273,1,24,0,4,25,54
416,2125,166581,1017,577,33716,204016
13519,11,222,4,29,95,361
49433,63,67,17,31,134,312
14283,3318,31255,2299,5770,20404,63046
959,485,3391,298,453,3691,8318
4825,64,420,47,75,349,955
14949,46,1273,26,45,434,1824
19255,462,7847,246,156,3644,12355
38758,5,175,1,12,38,231
3588,104351,874973,89613,78209,282731,1429877
19445,28,84,14,114,164,404
343,4091,33864,4514,5207,22651,70327
21255,25,337,16,66,329,773
12393,46,559,19,128,175,927
4024,67,730,47,111,496,1451
40341,7,137,6,15,97,262
50019,2,54,1,4,8,69
19237,12,528,6,22,91,659
35093,9,29,2,27,62,129
31440,439,11921,194,190,2988,15732
33456,1035,12859,720,286,7144,22044
33099,20,63,4,93,66,246
3281,129,1320,84,161,1116,2810
41312,12404,91176,2312,7135,24174,137201
37090,254,2901,88,126,2230,5599
10838,506,5950,395,1177,3351,11379
49385,14666,0,596,2522,13162,30946
4693,58,517,36,76,332,1019
1123,298,4567,371,378,1642,7256
42193,5,14,8,12,64,103
36792,2363,71277,902,729,26334,101605
37776,11,185,2,24,72,294
35626,1097,7778,261,678,3374,13188
15847,155,4927,90,120,2116,7408
9220,244,6334,175,138,2956,9847
43583,0,10,1,6,12,29
30134,14,56,5,51,63,189
9077,90,624,42,63,1078,1897
16638,1014,6754,492,333,2980,11573
33377,12751,32061,7274,19123,36337,107546
38235,2236,13273,836,1044,4368,21757
32383,358,3100,301,214,1930,5903
9464,14,106,8,40,138,306
17080,1239,9030,714,919,8409,20311
4262,2357,23395,1737,2535,14738,44762
32785,287,2180,134,343,810,3754
7770,326,1980,293,352,2498,5449
25985,5,356,5,48,66,480
896,819,111970,351,314,5698,119152
2475,130,1509,81,196,1305,3221
2127,112,764,116,153,954,2099
46324,2,5,0,11,24,42
30247,12,131,8,45,97,293
10457,758,4606,407,332,2484,8587
11887,32494,464450,20183,19622,211568,748317
11099,150,5690,83,96,2894,8913
9996,1845,3585,1746,1297,16298,24771
34234,25,37,3,89,73,227
35566,823,8005,385,247,11401,20861
40935,33223,191930,7755,4458,108940,346306
23517,15,476,4,45,130,670
39795,1718,2890,593,372,1781,7354
35388,9,280,3,38,51,381
23359,348,8992,368,347,6145,16200
3711,507,4056,291,334,2374,7562
39967,23,269,16,42,624,974
43794,0,14,1,9,8,32
6194,682,6363,347,309,2178,9879
12433,101,3074,60,52,1434,4721
9832,16,303,9,40,187,555
41651,2,75,3,11,15,106
2730,353,5614,166,376,2360,8869
33702,134,523,48,69,784,1558
37929,8,28,3,29,57,125
38322,2,59,0,20,21,102
25687,2050,79721,808,751,22952,106282
823,214,2290,138,160,1303,4105
2483,76,1166,64,70,865,2241
15393,95,127,59,63,2194,2538
3765,59,557,48,122,506,1292
3473,26,1239,13,60,299,1637
3655,9568,75131,9503,10430,52354,156986
686,85,1525,77,69,1342,3098
38279,0,0,0,0,1430,1430
34310,22,128,14,73,193,430
43393,0,3,0,8,13,24
41627,8,184,2,4,16,214
3506,41,3543,24,41,478,4127
36598,21,739,5,17,125,907
40015,10,160,2,33,58,263
7058,6200,43174,4566,6026,31588,91554
914,1042,4854,761,1086,7828,15571
1660,270,1673,230,280,2845,5298
40083,1831,36470,606,377,13598,52882
1097,596,4002,356,617,4224,9795
43683,1070,22018,447,326,11873,35734
35735,1,140,0,11,29,181
40747,498,6014,183,225,9759,16679
15015,54,733,48,56,839,1730
2216,5461,38783,3571,3866,56589,108270
6272,29,206,20,59,624,938
48869,14,432,5,7,185,643
30928,8,29,3,55,41,136
9426,20,95,17,65,166,363
2600,32,326,19,47,405,829
34907,16,439,3,25,121,604
29821,27,213,25,64,252,581
38729,13,48,1,29,140,231
20025,12,118,8,81,83,302
32344,8,280,3,20,43,354
6841,26,819,6,53,182,1086
39935,0,0,0,0,4613,4613
48468,855,8472,343,286,2204,12160
29757,11,370,3,25,83,492
33526,4,154,2,31,41,232
2164,7382,44297,7179,4725,69177,132760
2649,39,2018,31,84,433,2605
7032,12,688,7,40,121,868
43365,0,12,2,8,10,32
35346,167,2942,76,117,1247,4549
35212,10,79,10,93,110,302
39207,7,143,1,14,49,214
34812,440,4334,225,135,3286,8420
30362,24,83,20,50,388,565
2155,1395,7087,974,1499,8848,19803
48087,0,6,1,10,14,31
39256,2,13,2,28,27,72
23765,11,116,10,47,169,353
9542,38,140,18,58,296,550
18495,3204,18114,2194,4992,18140,46644
5902,727,25591,283,472,4542,31615
5725,211,6155,168,266,1257,8057
18393,1645,97285,694,502,15712,115838
11665,8107,127836,3853,2085,76561,218442
38392,7,597,8,23,103,738
3917,273,1455,180,142,1001,3051
17669,28,112,12,87,167,406
21571,86,3724,83,116,1447,5456
1902,83,4538,93,74,1437,6225
1720,190,3669,165,126,2346,6496
1880,120,3423,58,58,1329,4988
43634,0,20,2,6,9,37
50655,6,262,0,3,38,309
5244,215,10010,233,144,4580,15182
39162,15,96,12,27,114,264
8364,60,2496,43,94,598,3291
105,874,10875,875,1450,7446,21520
31859,36258,411728,15535,23546,147436,634503
37643,198,191,77,127,470,1063
25473,14,64,3,41,107,229
48830,1,0,0,2,17824,17827
828,135,1036,90,118,638,2017
43640,0,27,1,4,9,41
22447,18,270,5,51,131,475
9812,17,95,7,65,131,315
5492,28,365,7,38,273,711
33151,37,256,40,57,628,1018
2852,1235,7302,589,458,2963,12547
1701,179,2365,95,109,1804,4552
2924,8960,123299,8000,6884,90334,237477
10989,14,109,7,53,147,330
3910,100,842,58,82,597,1679
38787,12476,83698,4403,6594,54053,161224
29756,67,685,43,65,1075,1935
6832,20,988,10,46,209,1273
22693,753,3703,543,697,3853,9549
41503,0,0,0,0,443,443
37337,9,95,0,20,42,166
32418,9,63,4,50,50,176
3268,497,9486,378,234,3135,13730
12793,13,99,7,62,90,271
23759,24,621,7,61,122,835
48046,0,5,0,9,12,26
339,42984,269138,28591,18295,249665,608673
31865,553,4104,276,489,2488,7910
1836,1391,32621,1275,2079,14875,52241
50698,13,122,6,7,70,218
42811,3,58,1,5,19,86
34213,9261,59015,2630,3425,47794,122125
48736,304052,10,3876,3919,127400,439257
25991,75,1563,24,58,706,2426
33940,8,114,0,32,65,219
6509,194,3011,272,695,575,4747
16259,36,205,23,45,293,602
9665,31,118,17,62,375,603
41111,3,27,3,22,32,87
35526,16,106,4,16,79,221
41646,3,65,3,7,16,94
3816,52,824,35,51,545,1507
34091,11,44,3,36,70,164
1335,414,16955,510,387,6199,24465
14381,11,117,10,68,109,315
10832,155,2341,175,150,1731,4552
4201,50,339,29,47,796,1261
3493,218,3828,164,179,1625,6014
42168,6,124,1,29,48,208
5525,10923,121748,9548,13736,43095,199050
34375,460,6478,231,184,5559,12912
4353,130,4850,105,181,1773,7039
3393,170,1212,105,127,856,2470
6830,13,720,4,43,102,882
28813,31,465,42,71,570,1179
35722,9,56,5,60,63,193
42129,329,2772,171,118,4990,8380
11859,2150,17222,1177,1816,15794,38159
6071,25,300,16,76,372,789
9309,496,2976,283,219,1731,5705
13859,996,27969,797,1026,8799,39587
33671,20,60,7,41,85,213
36065,7,121,2,12,28,170
38562,28,188,25,67,664,972
40628,16,225,5,23,68,337
3973,14,89,7,49,126,285
43286,0,7,1,6,13,27
39139,3,23,1,27,31,85
3438,124,2805,85,216,693,3923
41534,6,101,3,5,15,130
10588,14261,141642,11468,12503,62761,242635
18603,35,713,31,67,387,1233
15411,373,14558,242,214,5695,21082
35484,10598,111444,3567,6830,47758,180197
6267,27,153,10,50,376,616
9493,1061,6148,954,2078,6367,16608
37365,68,73,52,50,2104,2347
42208,2,93,1,17,26,139
44009,1,16,1,20,24,62
37762,2,57,2,40,35,136
13639,144,4632,66,51,2445,7338
17875,3057,25914,1048,494,5264,35777
10408,14182,510051,3848,998,180824,709903
16005,7573,72604,4099,3911,45582,133769
6311,42,292,24,104,348,810
41052,58,982,30,53,781,1904
22983,21,547,12,51,201,832
711,147,2035,74,116,2223,4595
21495,475,4817,253,377,3711,9633
8490,97,5466,96,210,1909,7778
42584,8,132,3,5,28,176
19429,11793,151621,7120,13397,62293,246224
48470,2847,4490,692,3409,9531,20969
31646,53166,265430,32731,20366,213431,585124
14199,15172,162378,7773,13219,72812,271354
32559,14,69,1,37,52,173
39468,13176,136071,4052,5350,51615,210264
2113,446,5382,384,484,3013,9709
4935,106,900,134,268,449,1857
438,365,7598,247,299,4739,13248
1108,631,8455,641,845,5382,15954
34572,472190,353002,113354,114483,225485,1278514
8521,9,100,5,68,82,264
7020,16,608,9,43,143,819
39685,3,19,1,20,35,78
3863,31,576,26,52,273,958
9624,2764,31078,1603,3112,19706,58263
36517,748,33500,265,639,13405,48557
8728,438,19351,468,420,8882,29559
37550,10,273,0,14,77,374
50603,35,0,5,12,128,180
36098,16660,524228,3831,1513,177953,724185
126,1157,14466,1174,1628,11344,29769
23901,32,284,22,99,367,804
41084,3,1,3,0,128860,128867
48876,11,1223,6,11,127,1378
8918,1756,23986,771,771,6593,33877
32016,959,4361,346,363,1716,7745
48539,5,9,5,30,38,87
38163,1189,13490,395,405,11836,27315
25377,11,219,5,40,67,342
31923,90,1032,92,112,1370,2696
35151,6,46,0,42,35,129
220,156,1258,107,130,848,2499
11135,2428,49578,1149,1336,17141,71632
26155,8,37,3,44,50,142
9741,1227,14568,508,647,5830,22780
22443,30,582,12,50,225,899
3461,95,923,77,94,983,2172
39205,29,0,16,38,55,138
41535,4,262,6,9,92,373
10464,2669,44271,1723,1436,16864,66963
16007,17,204,10,63,199,493
10049,6797,106222,3783,2708,30055,149565
33866,6,245,3,23,48,325
33993,532,5819,268,335,1311,8265
42660,4,62,5,26,38,135
38456,14,228,2,29,157,430
2596,7532,46907,6963,5908,67159,134469
3969,58,343,39,112,425,977
9056,52,5266,22,106,714,6160
7,4801,48673,5500,5705,38936,103615
45702,1,4,0,10,20,35
19783,18,63,4,37,125,247
50612,3,1,0,0,52955,52959
39674,206,3164,82,89,1312,4853
50054,3,110,0,3,19,135
50125,2,30,0,1,5,38
22675,16,201,12,63,142,434
35203,20533,338139,5175,28270,52389,444506
5838,18,772,6,39,128,963
41511,483,860,144,176,1831,3494
40029,45,0,14,44,65,168
20047,13310,132835,8767,15495,67540,237947
38126,5,100,2,53,37,197
7395,81,826,69,127,492,1595
13967,20,305,13,65,344,747
38656,33322,282716,9192,20065,92681,437976
17121,1112,44608,458,175,17922,64275
27525,4054,84803,2072,1811,32501,125241
42497,317,5155,72,128,1095,6767
8494,16,126,4,62,115,323
48322,1,4,0,9,26,40
38505,8,137,1,16,49,211
20125,22,124,10,85,129,370
2915,49,656,30,49,735,1519
30480,11,303,3,31,65,413
48892,194,141,46,79,2048,2508
1479,112,3056,107,79,1753,5107
19513,24,89,9,52,235,409
12065,423,5163,211,183,3449,9429
2170,251,6336,242,158,3247,10234
42979,5,34,9,34,84,166
37462,6,67,2,21,28,124
40088,8,18,4,26,61,117
21569,260,33034,180,200,4001,37675
4378,174,1182,90,95,713,2254
30206,1079,70817,499,246,13202,85843
23635,10,59,10,78,66,223
13541,22,277,6,36,135,476
46973,1,29,2,6,17,55
33208,244,1232,137,90,2602,4305
16273,856,44929,404,271,9196,55656
48005,0,6,0,11,14,31
10797,51,91,12,111,171,436
32878,3264,19655,1680,7200,13076,44875
35055,10,19,1,39,38,107
48292,1,15,1,12,22,51
35133,17,67,5,44,63,196
7728,636,16738,353,277,11219,29223
3223,112,1901,106,108,2050,4277
30097,16,167,3,51,86,323
19169,27,117,20,81,178,423
5080,277,6037,117,95,3301,9827
35683,87,212,76,68,4914,5357
37704,393,4983,227,99,7860,13562
2201,398,71396,266,270,4209,76539
3541,69,657,55,95,371,1247
38918,266,461,65,107,668,1567
2364,181,1706,159,314,1634,3994
40939,52,28,18,114,338,550
24873,8664,91526,4250,9354,28544,142338
35669,7,89,1,20,33,150
2259,356,1021,372,405,1712,3866
48123,1,26,4,27,108,166
30464,1339,28414,685,541,9719,40698
2355,302,14355,161,129,4334,19281
37663,304,1391,108,178,3539,5520
1961,379,13065,228,254,7215,21141
2185,207,2357,132,141,1126,3963
36968,9,63,2,22,32,128
49565,0,0,0,0,448,448
16812,18,205,9,76,143,451
40269,2053,59737,515,464,9202,71971
32871,719,21115,300,343,9993,32470
49573,0,0,0,0,444,444
5316,603,4733,313,376,1935,7960
6491,64,1007,31,64,557,1723
10110,16297,323119,7293,8999,88417,444125
14813,48905,914624,20592,17012,220547,1221680
47044,253,547,31,67,330,1228
1021,708,4356,655,882,5678,12279
2734,88,2802,64,77,1187,4218
49994,5,85,0,3,13,106
2604,1099,10404,1143,1412,8561,22619
2862,232,2328,121,185,1004,3870
7496,24,688,19,62,343,1136
8680,7,178,4,57,67,313
7295,16,1557,10,33,243,1859
6850,9,664,11,43,135,862
3297,4254,34393,2757,2722,67955,112081
3931,448,20031,214,239,5401,26333
522,1798,51162,886,533,36101,90480
8848,23,259,9,40,284,615
1416,195,6028,143,122,3476,9964
29589,12043,73242,8157,18703,30730,142875
2759,6553,380563,2689,1239,79752,470796
38199,547,2148,265,1572,2999,7531
34889,9,326,2,22,64,423
29307,57,194,31,98,288,668
40158,10,196,3,18,51,278
49939,789,0,28,39,210,1066
50288,10,531,8,12,63,624
46924,121,0,19,30,210,380
27559,21,104,15,39,242,421
35698,51,0,12,75,78,216
22361,21,333,16,37,215,622
16700,1117,43539,661,351,18143,63811
1253,836,37461,577,411,5665,44950
1349,448,5115,356,556,3981,10456
2654,55,3693,73,102,564,4487
12375,3518,13947,1309,887,6248,25909
4581,5495,53247,4026,4594,46503,113865
38527,144,3698,110,75,4359,8386
42962,2,1,2,1,80001,80007
35109,7,25,1,36,36,105
48947,2,21,1,9,43,76
10604,836,42534,415,299,9521,53605
43007,31140,88577,6646,21701,61696,209760
10638,841,44217,438,204,11284,56984
2324,532,6190,329,396,2337,9784
2831,30,528,26,76,475,1135
3166,1119,15113,1114,1794,8339,27479
35324,7,137,3,10,31,188
41776,2,38,5,38,82,165
9355,886,37627,487,270,8916,48186
18191,17,91,17,73,127,325
3324,451,4682,286,361,1847,7627
36653,8227,56649,3807,4365,45734,118782
33490,185,2091,105,152,1281,3814
10282,34,219,18,87,257,615
71,19489,283287,17331,15421,114666,450194
21551,14,70,6,71,113,274
43363,0,9,2,7,9,27
43608,18,6,10,0,269048,269082
36760,113,778,80,108,1398,2477
21489,13,165,4,60,105,347
43969,44225,114827,7466,23416,68109,258043
132,6118,59450,8400,7905,31438,113311
50265,22,3,8,3,118657,118693
48088,0,4,0,9,13,26
33393,367,2906,211,179,1336,4999
4062,152,524,134,158,1209,2177
14875,224,6176,176,138,3467,10181
6769,36,1756,15,52,207,2066
10916,105,6769,103,130,1677,8784
48486,7,22,6,55,133,223
40301,8,101,7,25,121,262
33170,169,2687,102,104,1910,4972
37952,5170,15720,2276,13125,23224,59515
42740,17,60,9,32,60,178
47982,1,5,0,10,20,36
17437,477,13806,263,181,7444,22171
29843,11,93,8,71,90,273
17215,14,118,8,66,83,289
11809,269,2172,260,485,1654,4840
39360,15,120,7,33,169,344
49079,38,0,6,58,162,264
11357,32,501,11,56,294,894
8227,18,271,13,74,219,595
43650,0,10,1,5,11,27
10694,1303,8290,684,508,4040,14825
4211,101,301,62,107,1024,1595
23007,9,75,10,77,111,282
44389,230,0,16,32,362,640
18583,25,78,7,48,159,317
40590,2,0,1,1,9995,9999
19073,9,68,3,34,57,171
34309,45,100,13,105,374,637
8551,41,659,26,60,478,1264
8631,115,123,64,125,181,608
42448,3,29,4,35,47,118
41260,510,4815,262,227,1422,7236
4801,55,220,28,87,317,707
22275,27,95,7,43,267,439
292,1065,11795,978,1520,5018,20376
36833,503,9657,305,192,8368,19025
36815,36,165,21,41,453,716
19919,678,2880,513,771,6395,11237
45682,1,6,1,9,16,33
3247,513,22405,330,293,6591,30132
1353,249,1295,126,190,1782,3642
8097,172,3564,116,104,2860,6816
24549,10,61,5,68,69,213
42278,5,76,2,9,35,127
37123,136,1711,84,92,1486,3509
16786,15,265,6,41,145,472
10622,519,22625,377,213,8686,32420
35248,4117,20358,2503,7930,17220,52128
35366,8,236,2,37,61,344
1550,412,3908,433,659,2517,7929
900,622,100346,347,281,5724,107320
47425,10,42,3,24,58,137
21969,12,115,5,65,81,278
25749,21,229,19,69,257,595
5620,44,720,28,87,395,1274
6336,10556,48295,4838,2099,21417,87205
34954,7,214,0,28,58,307
3085,799,12145,500,525,5575,19544
9510,1182,32382,694,694,7505,42457
29559,11,186,4,51,57,309
41793,1750,470,557,328,662,3767
42899,11,393,4,5,98,511
2250,97,1583,39,61,1017,2797
35249,11231,48331,4120,6711,39651,110044
35178,607,3742,288,284,1292,6213
37255,7,41,3,33,44,128
1685,515,15335,631,2464,2436,21381
1699,8308,86063,8583,8663,58587,170204
9396,242,13444,152,123,3358,17319
50462,14,126,7,9,299,455
3898,107,2196,69,102,1454,3928
50768,944,6188,137,114,4977,12360
35124,5,20,2,35,33,95
890,1185,6121,1133,802,9299,18540
1565,3908,100928,3943,6792,8916,124487
7759,132,2090,113,124,1720,4179
4551,4968,68876,3924,4447,31581,113796
2152,614,4838,713,807,4704,11676
3420,3352,36208,2905,2550,39505,84520
19235,12,654,2,23,116,807
30614,1474,10314,768,558,4121,17235
42593,140,426,144,81,3985,4776
40713,7,215,3,6,29,260
11577,8179,397866,2968,1188,111569,521770
42142,6,334,3,14,77,434
30652,1846,10207,1030,2803,9217,25103
3529,174,955,114,119,757,2119
33662,13,78,12,79,102,284
4452,35,401,13,36,318,803
36271,8,52,2,38,31,131
25815,17,93,5,48,181,344
48903,2,2,3,1,34337,34345
43595,0,7,0,6,10,23
1373,123,2891,134,124,1833,5105
9124,106,5543,78,97,1929,7753
36084,10,138,2,12,40,202
42612,2,81,2,6,13,104
4596,729,23482,609,528,12992,38340
10080,8613,295272,5324,3997,44831,358037
6987,2953,84795,1136,1911,17343,108138
32788,8,178,4,20,34,244
35746,516,4141,149,192,11642,16640
1279,379,6323,364,405,3758,11229
2731,34,316,27,62,451,890
49290,285,733,124,116,2093,3351
8763,30,264,25,95,230,644
38777,4578,14880,720,774,19422,40374
3460,69,754,72,133,512,1540
40693,72,691,23,54,786,1626
1311,330,29898,305,287,5741,36561
633,498,4622,339,362,5266,11087
1611,92,1645,67,102,1148,3054
43502,0,9,1,7,10,27
43625,0,18,0,4,8,30
50037,5,257,0,3,31,296
9693,918,10215,869,1528,7179,20709
37863,61,1613,20,48,462,2204
31676,169,2210,97,102,2939,5517
49066,870,3892,174,304,3257,8497
1733,88,2535,46,63,1122,3854
33255,89717,550309,41867,28131,163168,873192
3194,73,757,54,135,504,1523
48628,10,28,3,29,65,135
7857,141,3005,136,151,1674,5107
9005,206,2216,138,107,1826,4493
30425,10,385,4,26,41,466
35113,114,497,72,189,965,1837
39536,4,114,2,14,46,180
10405,34,2450,26,52,554,3116
3254,197,1398,110,128,1008,2841
37290,257,32,104,104,325,822
8707,32,288,19,59,245,643
33831,6,32,4,42,66,150
29501,9,142,6,48,60,265
824,354,3769,247,349,2876,7595
40672,3,26,3,32,37,101
29357,5,109,4,36,38,192
18857,1449,113000,747,1025,14601,130822
2913,85,852,88,132,1175,2332
45195,100,62,24,60,183,429
9467,709,3169,340,310,1575,6103
40121,76,68,18,87,585,834
43763,1732,6326,415,2732,6545,17750
4470,35,155,26,71,346,633
37887,485,1192,131,170,1455,3433
5460,893,44957,314,370,5753,52287
185,19194,187223,10470,6065,72522,295474
34982,11,254,1,31,60,357
6658,38,172,32,143,317,702
49654,7,134,5,12,49,207
32224,8,86,3,40,49,186
31562,16,73,8,79,143,319
4188,1470,15257,745,528,11315,29315
45598,1053,28845,302,321,8989,39510
18457,30,660,25,82,168,965
47398,929,24257,274,282,11181,36923
34525,6136,40889,3027,9565,22708,82325
38047,12,602,6,12,110,742
48331,1,10,1,13,24,49
11813,5604,32582,2099,963,10845,52093
41205,81,203,43,51,1880,2258
5458,234,13563,147,188,3028,17160
3234,141,2739,93,110,1706,4789
28511,85,1874,49,84,882,2974
8368,71,2324,43,92,612,3142
30419,209,3877,118,97,3440,7741
195,4451,117946,2941,4545,32079,161962
50103,2,17,1,2,3,25
38472,19932,228291,7257,10970,69832,336282
9751,834,24632,464,340,12600,38870
2463,281,335,137,77,1565,2395
34354,14,118,8,47,84,271
16796,10,61,3,43,85,202
8536,4362,78081,2588,3965,20819,109815
1636,290,3697,209,234,1505,5935
2026,15817,103660,16932,16579,56565,209553
40994,73,163,27,46,475,784
43225,0,19,1,10,11,41
49437,3,94,2,4,16,119
37990,211,2911,92,264,829,4307
41277,7,27,3,33,54,124
18533,16,361,11,47,236,671
2360,112,2164,64,115,968,3423
9949,16,84,6,57,67,230
36520,53,1374,19,86,251,1783
1539,63,1971,45,86,802,2967
36287,15,428,14,41,175,673
50185,16696,1,384,467,16785,34333
3406,113,1044,116,144,2066,3483
24817,108,576,66,88,578,1416
24271,655,3208,316,216,1503,5898
2745,119,1420,70,63,1199,2871
48038,0,3,0,10,13,26
39150,19,1157,8,23,127,1334
2967,244,2135,156,254,2253,5042
32511,219,1746,149,140,2462,4716
36823,376,4591,115,144,2418,7644
28237,14,196,9,48,155,422
24703,22292,602534,8509,11230,57814,702379
13369,6,282,3,28,107,426
1218,1696,28993,1279,1919,11670,45557
13373,51,3810,25,60,489,4435
8339,268,8653,114,239,3382,12656
22777,7761,124152,3451,4176,18034,157574
1689,14680,617698,7337,5626,179182,824523
34500,19,169,6,32,68,294
35171,7,38,1,46,48,140
10757,31,274,29,122,173,629
2273,597,46467,310,233,6430,54037
35593,12,115,6,41,94,268
36714,56,472,28,58,752,1366
43275,0,10,2,11,10,33
10040,13,155,7,51,109,335
10380,1544,25585,680,600,4483,32892
44407,14,1325,2,11,93,1445
23753,53,465,32,59,560,1169
32257,24,156,13,49,211,453
48378,9,407,8,10,56,490
37531,11,367,1,13,83,475
364,738,3503,747,702,7302,12992
10999,228,11770,115,157,1976,14246
2869,316,3505,186,204,1442,5653
18669,30,648,31,55,497,1261
8415,26,133,14,63,263,499
31309,19,692,4,27,104,846
17267,409,5038,324,739,3514,10024
32852,8,199,3,20,50,280
10909,17,218,12,81,187,515
43513,0,16,1,8,15,40
6981,43,147,25,65,305,585
29963,6,153,1,29,41,230
33276,23,722,21,61,314,1141
30926,7,64,5,70,50,196
24453,548,3454,272,224,1359,5857
38632,21,510,16,57,267,871
37490,2703,16058,1456,1447,11641,33305
49977,8,194,1,6,37,246
15533,46,489,18,49,302,904
20441,33,351,12,63,364,823
30898,672,4636,325,251,2102,7986
6970,50,243,40,101,401,835
6954,1868,71246,1026,492,30029,104661
36819,7,109,1,16,27,160
2415,230,2386,142,215,1165,4138
10418,1132,104988,736,505,18959,126320
23801,9,53,4,54,90,210
35558,877,2662,389,311,1255,5494
24999,6,244,4,42,58,354
50046,25,524,28,20,251,848
9177,52,246,34,78,639,1049
49116,1,8,0,11,17,37
20869,12,265,5,33,74,389
3025,83,812,34,54,767,1750
10941,14,652,6,23,89,784
17147,127,648,169,142,736,1822
201,762,15002,626,518,8902,25810
11763,3368,18344,1916,5766,20368,49762
11483,182,6058,74,102,2500,8916
1895,249,2565,139,166,923,4042
39392,2539,12449,833,642,4151,20614
40452,4,115,3,11,37,170
46093,28708,29118,6810,9227,63574,137437
9926,6925,154773,3319,5052,28986,199055
38816,5689,100408,1872,1163,74734,183866
37344,8,222,0,10,54,294
29707,30,1421,14,40,267,1772
3649,163,1622,75,147,740,2747
29798,6,158,4,39,47,254
34704,7,16,2,39,35,99
9846,48,1223,33,58,703,2065
1793,376,8868,194,184,6776,16398
4017,137,846,85,115,698,1881
37070,8,81,3,20,29,141
5006,31,784,14,60,270,1159
43429,5,34,6,9,51,105
31098,6211,81378,2874,2570,25991,119024
3586,139,1031,89,120,566,1945
12059,1369,12606,648,755,4308,19686
18881,201,5301,242,311,3715,9770
37962,2964,8574,909,648,9924,23019
48009,1,8,0,12,19,40
2248,638,63460,388,304,6356,71146
32222,28,685,23,77,585,1398
38376,8,154,1,19,44,226
32693,10,120,5,59,75,269
22101,14164,163243,8144,11016,74735,271302
33761,72,253,32,66,664,1087
45696,1,7,0,10,18,36
32734,16,139,6,59,111,331
6985,141,3618,82,158,2380,6379
43431,4,8,6,14,24,56
9824,35,487,15,43,392,972
10390,178,3847,152,229,3255,7661
38778,15269,135626,5144,11770,55132,222941
1654,180,11361,147,135,2598,14421
2681,158,1220,96,108,714,2296
1129,96,2280,71,62,984,3493
38980,12,707,2,31,59,811
35853,0,0,0,0,2364,2364
10586,7,592,6,32,73,710
31044,358,350,221,337,1508,2774
1737,121,538,83,125,1099,1966
652,224,6378,245,231,2349,9427
31785,144,1417,86,91,1963,3701
33696,22,2600,16,83,210,2931
11969,446,3490,219,201,1171,5527
35536,7,92,2,19,24,144
14893,926,48669,434,331,9471,59831
1541,704,4087,458,530,5022,10801
17213,13,106,7,65,89,280
3315,64,237,58,94,605,1058
2098,205,4552,128,120,2683,7688
2341,592,5063,288,359,5635,11937
3752,34,1207,20,64,339,1664
31251,18258,119420,9770,8186,41948,197582
11457,1834,5018,1290,2192,3803,14137
33969,1162,3047,498,502,7638,12847
34235,25,39,7,95,97,263
48678,90,205,93,43,2912,3343
8017,86,1469,66,85,894,2600
48084,0,7,0,9,11,27
19103,531,3177,290,224,1492,5714
101,8054,179693,8582,10560,71675,278564
34514,1330,40880,785,560,4964,48519
22179,18,1655,13,74,213,1973
39404,1,10,4,33,25,73
474,1152,25687,615,438,14161,42053
11705,169,5594,107,173,3171,9214
24257,14,100,5,41,116,276
2167,57505,821783,42918,42446,305820,1270472
49592,237,137,43,37,1213,1667
39606,425,12016,155,96,3733,16425
1277,146,2449,108,105,2012,4820
12581,1502,36024,534,530,10119,48709
21945,13,95,5,60,75,248
7485,35,2009,15,58,220,2337
31903,51,79,30,58,354,572
3901,2148,134675,1621,946,26684,166074
37890,2797,17480,1029,1876,12225,35407
4534,47,480,32,46,544,1149
623,281,1649,301,399,3051,5681
24793,25,311,15,60,248,659
37525,10875,48132,5125,8773,49281,122186
21293,14,121,6,68,76,285
119,1048,22638,808,1159,7815,33468
36440,429,449,190,399,1982,3449
11911,125,1396,99,146,936,2702
31319,267,2620,119,192,1623,4821
38524,67105,1540191,7370,4707,119069,1738442
32768,10,202,3,20,50,285
35413,20002,159936,8088,13340,85339,286705
18389,23,132,10,46,136,347
1607,1262,13749,1329,1965,9730,28035
36636,15,171,10,33,123,352
49476,0,35,1,4,13,53
17002,14,146,8,39,212,419
17233,21,205,9,45,295,575
504,236,9222,113,87,2244,11902
9905,27,236,18,93,302,676
40741,3,94,3,6,18,124
28111,12,59,5,25,63,164
2500,395,5662,193,135,4927,11312
39091,18,0,7,23,37,85
3736,281,1088,259,399,1368,3395
16890,6687,53158,4110,6938,36364,107257
3958,7467,81242,4874,4351,55841,153775
37626,5,332,8,26,96,467
43565,14,372,2,22,181,591
50433,0,0,0,0,67,67
49989,223,1123,117,91,410,1964
30143,50,973,31,72,604,1730
39886,4,126,0,17,29,176
33750,232,2573,151,168,722,3846
11701,1526,149095,882,498,22578,174579
1652,175,2210,141,148,2720,5394
6548,291,23616,194,184,4471,28756
43366,0,11,3,10,11,35
1739,57,120,63,108,283,631
39282,671,3496,233,491,1822,6713
9732,21,1337,4,32,189,1583
6425,785,10822,498,891,6960,19956
37233,974,8338,501,378,2434,12625
2545,55,870,48,130,539,1642
39036,5,84,0,18,35,142
28121,47023,1066099,17415,27438,154797,1312772
4940,25,123,17,73,248,486
32869,605,21403,294,309,9635,32246
5184,26,68,13,71,167,345
37357,16,628,6,16,114,780
36278,16,281,3,16,104,420
39501,2,14,3,26,28,73
5285,82,568,51,87,379,1167
28607,1723,24252,1053,825,10446,38299
33845,781,17836,531,389,20265,39802
8883,25,115,15,40,274,469
44410,172,237,19,68,320,816
36631,17,143,4,14,106,284
35143,16,162,8,66,94,346
49834,0,0,0,0,1197,1197
12883,8467,67590,7146,7185,66724,157112
26033,11,55,5,49,115,235
44752,12,166,5,25,215,423
34700,8,76,1,34,55,174
40104,50,432,20,49,662,1213
25491,44,496,21,47,351,959
3648,144,944,64,95,504,1751
41299,77,176,44,66,803,1166
38554,12,220,4,43,68,347
29771,15,652,7,32,111,817
12753,2398,28139,2202,2022,10938,45699
42271,2,74,2,10,36,124
2492,40,1142,37,84,669,1972
2436,226,3391,146,179,955,4897
43600,2,0,0,0,4758,4760
42722,2,67,3,7,14,93
34891,29,52,10,125,136,352
37716,6691,37702,3090,5374,28410,81267
34662,37914,247840,16633,23695,89331,415413
27455,13,208,10,64,66,361
10209,3653,100728,1950,901,17437,124669
1202,233,8922,151,147,3340,12793
22621,11,154,9,62,112,348
14095,36,711,18,69,329,1163
4616,21,579,15,89,153,857
36783,216,1570,128,152,2793,4859
2835,764,978,689,475,3772,6678
466,390,25015,313,239,5541,31498
8648,272,3007,297,251,2310,6137
43637,1,24,1,4,7,37
13781,16,119,5,50,145,335
36873,8452,72186,4500,12208,25865,123211
17951,21,366,7,45,155,594
39367,2,16,3,29,34,84
9934,1224,7872,941,1815,7239,19091
2677,47,4972,41,108,530,5698
28537,2100,9298,1461,4152,11626,28637
9819,11,110,4,46,88,259
39393,3,184,3,12,28,230
9390,18,290,13,48,224,593
1528,68,885,48,75,767,1843
31418,996,19495,523,266,15357,36637
1427,85,3017,87,94,1903,5186
36324,6,18,2,38,28,92
18591,13,138,8,63,84,306
39735,31,733,12,46,464,1286
15479,30,108,17,60,165,380
4209,354,2533,326,480,1822,5515
10115,34,592,14,71,422,1133
2958,358,2719,235,234,1367,4913
48882,2,51,1,2,11,67
5462,114,6073,107,137,1218,7649
35028,1709,8103,635,481,2901,13829
6989,35,158,39,139,235,606
39230,15,67,7,58,109,256
36386,7,112,1,18,24,162
17237,58,238,48,122,276,742
43808,1,7,0,8,12,28
36061,12,209,3,14,40,278
7230,50,1062,29,29,776,1946
34166,61,118,31,78,966,1254
34832,0,0,0,0,3918,3918
30014,7758,39915,4359,5414,32307,89753
29970,9,154,1,31,49,244
25313,830,23445,417,323,10529,35544
13195,10,372,3,25,81,491
48239,48829,4,893,2483,25017,77226
12431,17896,41796,14114,7574,90148,171528
49891,1,0,1,0,5072,5074
15159,43,992,25,47,711,1818
42657,83,363,39,254,213,952
10294,2465,33622,936,509,33562,71094
39849,144,888,63,188,330,1613
10697,588,4676,296,375,1835,7770
35965,102,2573,47,70,1806,4598
50416,0,0,0,0,1686,1686
42815,15,19,8,37,249,328
9340,31,743,20,65,449,1308
39431,7,233,10,38,70,358
5931,25,292,16,63,330,726
29469,9,69,7,60,54,199
32739,76,1568,60,109,1133,2946
2892,53,970,83,221,418,1745
43496,0,11,1,5,9,26
33046,3411,19786,1768,3841,13482,42288
35702,8,103,1,26,52,190
9181,7894,236969,3800,4113,45070,297846
38069,13,80,2,46,73,214
29483,9,78,3,35,53,178
45246,1,13,2,13,17,46
7750,28,105,15,63,233,444
3832,31,244,23,39,322,659
41574,900,4306,256,834,5760,12056
41444,4,156,1,6,25,192
35078,8174,33578,4056,5581,36902,88291
49907,3,25,2,12,23,65
1533,841,11743,1047,1875,4878,20384
5812,16,932,5,42,102,1097
10886,174,4082,114,147,2212,6729
28547,9,39,2,55,58,163
29765,25,377,14,28,428,872
144,1597,34718,1578,2665,19847,60405
36583,9,96,0,23,40,168
7193,12357,64814,10225,8442,101500,197338
9750,7134,72368,5087,8541,30726,123856
50050,1,10,1,15,17,44
48203,3,19,5,25,26,78
38896,5,141,2,7,32,187
3015,272,7226,209,169,5365,13241
49123,1836,0,66,64,1289,3255
2432,2778,19272,1032,1119,6816,31017
38784,209,2223,108,108,2248,4896
2055,70,897,41,51,938,1997
14069,11,130,4,41,74,260
2520,369,23225,244,290,4203,28331
49581,7,115,1,11,36,170
9254,69,421,46,57,1152,1745
6567,139,2390,73,79,1730,4411
43214,0,12,1,7,10,30
49952,332,0,19,51,183,585
34632,22,253,12,27,160,474
30942,7,51,4,59,49,170
29916,738,3400,330,320,1592,6380
5829,50,306,31,103,367,857
26395,544,15513,274,261,3542,20134
34418,6,212,1,14,39,272
41808,7,50,8,32,101,198
28915,40,501,32,83,524,1180
2557,298,3815,256,242,2317,6928
33762,57,97,20,51,387,612
26253,7,37,3,40,38,125
29749,8,89,2,30,71,200
43653,1,13,1,4,8,27
41622,2,114,3,8,17,144
22619,9,104,7,43,84,247
23293,633,14846,258,188,8704,24629
32380,3844,309899,925,549,27829,343046
33763,38,71,10,51,173,343
1640,366,13758,294,773,4379,19570
2010,110,2538,91,70,1652,4461
10740,234,36389,232,225,4077,41157
3323,681,16736,309,254,8546,26526
20021,3788,245098,1408,1741,30625,282660
5300,7608,146764,4177,1850,62682,223081
19167,22,76,5,46,150,299
1187,193,9114,200,115,2310,11932
34279,29524,129592,11119,21733,69676,261644
5560,52,457,47,103,319,978
49620,18,47,9,19,116,209
4091,38,1778,19,39,643,2517
3157,108,1935,108,96,1271,3518
42397,2,43,3,20,56,124
19619,54,802,33,79,480,1448
38412,23,343,17,55,226,664
10800,24667,193630,18902,15031,153793,406023
4848,97,636,60,87,432,1312
2977,151,968,90,134,762,2105
33743,16559,160018,6921,20969,57962,262429
6762,10,131,5,51,108,305
1214,787,7736,784,985,9168,19460
31638,8,102,1,30,44,185
2772,1897,10958,1736,1990,8444,25025
317,1542,187861,509,514,11339,201765
29955,8,269,4,19,47,347
33528,12,80,5,37,100,234
23659,19,155,17,62,243,496
33228,43,341,30,69,561,1044
3579,470,1842,426,379,3691,6808
47160,4,0,3,1,110397,110405
50052,8,33,3,33,61,138
36689,767,4307,399,299,2364,8136
20147,16,81,9,76,113,295
40558,10,327,5,10,53,405
30334,9,250,4,38,77,378
33142,2287,49297,1136,1603,13107,67430
11827,3636,19201,1515,1299,7357,33008
30198,9,61,4,40,62,176
23881,26,103,11,44,142,326
38130,8,162,4,20,160,354
28623,47531,464243,15805,27668,149042,704289
28021,11,58,2,51,87,209
16668,7851,92989,4259,6844,43812,155755
859,2112,61900,2644,4666,8342,79664
20873,22,168,6,52,117,365
35573,383,1958,163,159,647,3310
40735,792,2375,182,238,2323,5910
35153,6,18,2,39,31,96
35347,154,3154,58,81,1707,5154
47060,1,5,0,9,17,32
2615,141,8870,103,106,2018,11238
33874,19,243,18,50,234,564
5476,84,379,72,149,654,1338
3356,170,1092,243,324,1573,3402
31675,449,9589,354,355,7985,18732
27371,13,109,4,61,77,264
23321,35294,393401,21562,19012,82589,551858
44056,0,0,0,0,3422,3422
30119,62,0,14,106,138,320
35379,22,151,7,57,103,340
42381,6,204,5,6,27,248
27683,11,94,6,67,81,259
20143,20,89,7,47,157,320
38137,4,81,2,43,36,166
24,13740,169677,13850,14496,90538,302301
50191,4,35,5,11,122,177
2240,64,465,42,82,428,1081
27687,31,314,18,90,152,605
10104,67,906,40,63,655,1731
6939,51,572,23,63,566,1275
35504,23,111,10,29,277,450
37044,338,2290,131,151,2291,5201
11773,214,1871,152,118,1829,4184
2389,553,3466,749,777,3453,8998
6800,52,1181,32,60,455,1780
25363,23,289,16,64,232,624
4522,44,642,24,45,401,1156
49664,83,78,22,96,708,987
14397,8123,145429,5047,3086,47925,209610
7721,19,185,17,55,97,373
50377,0,41,3,3,29,76
31846,54,1302,28,48,534,1966
41745,4,85,1,11,27,128
10075,799,37042,404,371,8733,47349
6560,602,4052,391,575,2872,8492
32228,430,10908,171,172,3014,14695
3023,140,404,133,176,967,1820
7583,374,2648,222,207,1248,4699
37143,13,221,13,80,122,449
3447,178,6941,167,162,4458,11906
39352,9,78,8,45,173,313
32993,108,3135,63,46,1136,4488
2896,547,5546,312,327,1819,8551
37428,22,33,9,72,86,222
6964,204,6149,153,155,3412,10073
3401,58,6166,87,78,1022,7411
50192,225,1426,75,85,1045,2856
34784,360,7992,216,171,5293,14032
24159,15,99,7,50,187,358
866,262,13119,211,124,4385,18101
32681,7546,82260,4365,4541,36851,135563
40117,38,231,12,42,212,535
49750,0,0,0,0,63,63
42897,140431,604986,18878,19339,165024,948658
1438,134,4077,104,90,2339,6744
38260,245,1016,118,118,459,1956
34689,14,67,2,25,75,183
37115,13,75,11,55,109,263
2017,144,3874,113,72,2874,7077
43379,0,7,0,9,11,27
35368,7,32,2,32,59,132
33280,1032,18837,388,236,15541,36034
22609,10,130,4,45,67,256
5203,72,787,50,116,489,1514
44275,5359,10547,969,1927,14071,32873
647,117,1649,86,103,1381,3336
30122,19,185,8,77,194,483
31706,4369,71572,2019,1684,30572,110216
41477,26,130,11,49,165,381
38361,143,443,49,56,835,1526
31832,7,567,6,31,81,692
3098,85,799,61,133,529,1607
43390,0,7,0,10,11,28
2012,1108,6582,1123,903,7847,17563
31749,59,300,16,58,483,916
31780,180,7180,95,112,1885,9452
8129,7398,126214,4937,3413,66334,208296
41725,4,176,0,4,41,225
3911,184,1601,139,143,748,2815
40205,9,120,2,13,84,228
31688,12,584,3,29,60,688
31883,815,4719,586,417,2477,9014
37869,2471,21111,1043,1297,9976,35898
51119,1,0,1,0,3426,3428
34636,23864,147515,11852,12909,85085,281225
1004,1333,67178,489,222,21207,90429
33697,107,3383,40,66,909,4505
39925,3,94,0,10,18,125
148,384,2958,370,454,4281,8447
7668,167,3408,88,112,1291,5066
3823,26,440,17,102,217,802
50033,2,98,2,4,16,122
16834,14,73,4,42,76,209
8230,192,9053,104,111,2968,12428
22887,12,61,6,69,90,238
23057,66,3162,19,61,736,4044
45616,3,106,2,9,22,142
1544,118,2185,90,104,1275,3772
4364,225,1081,131,140,977,2554
29844,8,48,5,40,44,145
28683,270,9936,184,210,2905,13505
271,634,5417,759,949,5047,12806
12225,66,1322,47,47,715,2197
8063,1835,53867,692,583,8627,65604
50622,126,1359,52,75,266,1878
34999,205,1309,80,74,1846,3514
5096,96,7466,80,118,620,8380
29846,26,66,24,83,227,426
27379,11,73,7,78,94,263
23935,55,1162,56,103,674,2050
28695,45,519,10,62,211,847
29920,6,165,6,43,83,303
14367,43,419,34,58,527,1081
39679,54,48,30,57,172,361
46295,1,5,0,9,21,36
37150,2423,10626,493,804,6892,21238
38767,175,1985,89,158,1424,3831
37921,525,12256,259,173,6779,19992
41167,22,863,10,32,162,1089
50392,0,0,1,0,8782,8783
617,2535,76546,945,525,37254,117805
30739,231,3228,114,132,2075,5780
394,1279,42398,1150,1197,9205,55229
3334,218,1139,125,147,804,2433
230,1749,18366,1708,3190,10418,35431
28091,22,76,9,59,186,352
864,199,7981,144,166,3053,11543
1594,6861,81759,5706,4223,49881,148430
4591,290,1349,213,331,2450,4633
32596,53,74,45,117,298,587
23153,513,7141,316,172,4093,12235
1118,834,154170,268,302,4160,159734
5420,4738,20644,3720,2644,45184,76930
6772,1541,57809,725,523,20044,80642
36757,19,218,6,31,153,427
38003,26510,313659,9824,4401,112176,466570
28539,695,10898,319,256,10260,22428
30025,12,48,3,51,51,165
15525,10,321,6,43,112,492
2427,104,2753,49,90,1810,4806
30034,13,75,8,56,96,248
21963,12,102,5,62,81,262
47250,12190,21193,3780,13213,33844,84220
5967,202,4885,127,234,1311,6759
36184,316,258,120,94,1194,1982
11543,22,1801,8,33,177,2041
10904,37,408,26,94,461,1026
23857,23,93,10,66,105,297
23899,17,111,12,61,182,383
42807,6,82,1,5,22,116
178,1345,16477,1443,1698,9306,30269
42047,9,142,4,23,72,250
33690,902,4442,402,2445,4324,12515
31689,14,885,5,38,86,1028
733,253,7837,141,230,2293,10754
34277,1226,47279,479,267,18901,68152
25857,80,1050,45,93,860,2128
34453,415,4164,100,190,3314,8183
2928,354,13578,268,291,6030,20521
31049,1604,16726,1029,2435,3004,24798
35115,33,445,15,55,269,817
21773,261,7727,107,132,2515,10742
39343,3,43,4,22,43,115
670,1556,22276,1249,1853,12430,39364
1629,1159,6608,832,1076,11706,21381
16574,114,2491,114,166,1871,4756
41402,41635,98331,5156,2950,56164,204236
38864,100,1759,70,140,1356,3425
45611,7,101,2,26,52,188
7030,15,1109,8,49,174,1355
41637,14,176,13,27,91,321
44081,0,0,0,0,2509,2509
8936,22,942,15,37,477,1493
28249,25341,183450,17137,19051,95226,340205
7122,45,356,49,86,767,1303
41813,3,19,6,51,60,139
49918,9,1,12,2,135005,135029
4161,143,787,75,124,809,1938
37335,15,52,5,39,50,161
31235,31,56,18,45,454,604
41904,0,64,1,3,21,89
34257,1016,6997,460,740,7552,16765
30648,22,333,13,53,237,658
35222,17954,169291,7268,6516,63826,264855
16510,31,102,9,44,312,498
48896,0,0,0,0,13101,13101
7154,52,266,33,71,273,695
43220,1,12,1,7,9,30
4073,54,478,41,96,368,1037
24049,22,145,12,28,135,342
35533,12,102,1,16,41,172
33150,68,650,59,105,966,1848
20799,13,113,6,49,135,316
37437,0,0,0,0,2969,2969
1148,402,3057,196,260,4749,8664
11807,766,3111,366,304,2312,6859
30342,22,86,9,81,122,320
39116,32,237,11,28,176,484
4921,138,3903,65,107,1547,5760
8115,613,9844,316,207,12630,23610
34787,566,1710,248,427,2485,5436
32437,349,4269,206,246,3531,8601
5681,7624,346258,2803,1421,114833,472939
19457,17,69,8,56,78,228
48033,0,3,0,8,16,27
14631,9,101,5,64,129,308
29988,9,358,7,38,85,497
42153,7,35,4,22,72,140
24089,22,150,18,38,211,439
42192,41819,48594,9036,14025,66512,179986
3019,96,3124,89,85,1983,5377
38385,6,333,3,16,99,457
38957,20,946,10,18,191,1185
32805,625,2144,450,1209,1629,6057
37520,110280,545741,43737,31528,230486,961772
37078,3400,66957,677,588,21065,92687
3900,131,455,123,185,1017,1911
23569,8,37,6,49,184,284
37356,15,666,8,14,147,850
21275,19,117,10,57,99,302
37853,9,148,1,16,47,221
34050,46,585,14,47,405,1097
12823,356,11441,314,270,6361,18742
4731,124,599,74,122,504,1423
11421,13,109,13,71,125,331
23633,10,65,11,74,85,245
49991,4,16,1,13,30,64
20381,30,423,17,80,418,968
48344,1,11,2,24,22,60
39888,3,140,2,16,39,200
29207,7,85,2,41,59,194
3970,826,6175,396,352,2447,10196
7696,33,224,12,43,278,590
7781,73,117,54,86,2888,3218
23721,21,112,13,65,137,348
30919,219,6101,128,91,2834,9373
30058,12,249,3,35,93,392
33542,63,186,29,60,255,593
20035,534,15332,330,182,6467,22845
29752,14,149,9,64,117,353
15749,94,121,153,151,191,710
30664,8,273,6,34,78,399
13455,20,96,8,84,129,337
31772,13158,222930,5341,2351,29478,273258
18557,46,512,26,62,528,1174
40124,52,193,32,46,866,1189
20227,9,58,5,47,72,191
37539,13,122,1,18,69,223
44511,18,3,18,0,346128,346167
2771,105,324,121,175,1088,1813
6524,11,135,7,50,79,282
4934,42,673,21,68,388,1192
8217,564,5815,462,550,2805,10196
44163,0,8,0,9,13,30
33420,61,1863,19,64,404,2411
19211,888,29628,575,287,6693,38071
39527,1190,4627,494,3427,7832,17570
37193,6,83,1,21,23,134
2546,126,2058,119,200,1118,3621
32447,2932,17159,1069,4329,14333,39822
36656,11,35,5,69,53,173
4387,67,1290,45,82,585,2069
26085,1930,22625,883,2783,10444,38665
9924,173,3789,117,103,1565,5747
38145,12629,91179,5295,6265,47707,163075
38500,7,148,1,10,30,196
1966,87,1178,54,112,1213,2644
33389,41,141,33,45,723,983
18151,508,2653,269,223,1447,5100
36220,9702,99586,3632,3120,73088,189128
32167,9,131,0,26,29,195
21441,64,3434,25,34,483,4040
34863,1631,9730,732,877,12841,25811
42846,6,51,0,4,14,75
7580,1859,26408,1134,1317,14637,45355
89,1426,11339,1208,678,8788,23439
42618,4,87,2,7,23,123
19631,1011,6194,549,470,3006,11230
577,379,3004,391,566,3483,7823
10741,17,101,11,45,203,377
16650,19,129,13,70,166,397
17855,145,6020,68,66,1834,8133
33465,15,75,4,36,86,216
21875,40,831,11,34,353,1269
16592,30091,617315,14244,22454,143469,827573
28353,8,50,3,31,51,143
44073,0,0,0,0,180,180
43571,0,8,0,5,14,27
1169,171,2666,131,84,2621,5673
33888,10,112,2,35,51,210
40595,24797,114489,6381,14253,57130,217050
48008,0,6,1,17,12,36
34792,1258,19675,522,240,22231,43926
36394,8,80,3,21,25,137
34240,4184,266320,644,514,30001,301663
34368,3477,16800,1883,7031,14604,43795
25517,8007,63534,5855,5578,26997,109971
2466,54,738,36,40,478,1346
31338,20205,226160,6660,18841,52552,324418
32476,154,1906,99,128,2530,4817
48432,9,224,2,20,65,320
4420,25,671,6,49,296,1047
38099,38,0,11,67,77,193
33546,151,1287,60,80,1191,2769
36318,4414,41384,1423,1953,7660,56834
1620,108,972,72,110,915,2177
10717,805,24243,357,202,10152,35759
22637,12,133,7,43,84,279
38831,615,1526,235,224,954,3554
32282,40804,842424,11547,9579,88926,993280
33872,15,220,3,25,88,351
40292,14,786,7,33,137,977
9568,102,1179,56,57,1238,2632
1632,289,2843,182,150,1228,4692
15793,2635,33991,1479,1358,14368,53831
38819,6,274,1,24,56,361
36167,5,56,3,25,46,135
29573,668,4550,372,260,1976,7826
24457,134,1183,101,110,1219,2747
40338,11,571,3,14,90,689
37491,7253,94216,2213,1350,51504,156536
38872,4,56,5,42,93,200
14827,1435,14565,827,1221,10097,28145
4503,244,3721,243,250,2448,6906
29635,8,328,6,37,91,470
44961,131674,5,10585,31873,123024,297161
28551,4,49,3,54,50,160
36077,298,2716,106,112,4864,8096
15591,305,13766,207,126,5373,19777
38250,916,1354,498,429,4289,7486
48100,0,4,0,10,15,29
34544,2672,66562,901,412,33679,104226
6438,315,15785,146,205,2695,19146
22729,18350,332077,10196,16431,96105,473159
35522,146,2760,55,46,1282,4289
39165,15,1645,2,19,104,1785
5546,60,282,34,78,304,758
39555,3597,101671,926,824,20570,127588
8026,127,4786,59,67,1502,6541
41768,6,414,1,8,51,480
50098,27,1327,13,21,231,1619
41099,43,971,19,35,341,1409
3336,64,1523,52,73,1397,3109
41449,6,238,4,17,40,305
22901,394,2028,186,155,955,3718
45521,1,9,0,11,18,39
39478,844,4167,497,568,10935,17011
44270,178,2867,101,76,1569,4791
6482,24,121,20,76,301,542
36638,13,161,2,20,85,281
49849,0,0,0,0,968,968
393,1205,40699,708,567,19588,62767
38087,44,127,29,76,686,962
17082,3040,46273,1459,2067,27507,80346
26309,11,38,3,43,68,163
24053,13,149,3,21,82,268
20471,0,0,0,0,6137,6137
17137,112,1268,60,70,1483,2993
49898,2,64,0,2,11,79
36081,8,123,2,11,31,175
2710,27,283,8,68,192,578
5834,110,442,108,167,1375,2202
3063,131,1059,79,107,600,1976
43260,0,7,2,8,9,26
35587,3,196,1,13,51,264
2636,16,201,13,43,126,399
10030,10612,244765,7014,4173,55705,322269
30091,7373,46024,4759,18616,26561,103333
9201,2312,45111,1241,896,12362,61922
7139,39,604,19,42,398,1102
23613,15,77,3,66,82,243
1764,247,12157,171,145,3802,16522
39862,7,95,0,25,78,205
31738,55,872,13,48,337,1325
29177,11,132,2,35,46,226
2047,50,2813,23,64,808,3758
37732,6,100,3,8,30,147
37672,170,2111,51,91,824,3247
31237,14,56,6,81,88,245
35695,48,0,18,71,72,209
38664,234,5320,84,74,3193,8905
39820,19,62,9,104,66,260
36385,8,66,3,21,28,126
23735,339,4547,186,177,2161,7410
2387,113,1758,81,87,2177,4216
42214,5,31,2,22,54,114
22633,13,112,9,69,135,338
1608,476,3429,324,404,4138,8771
13799,107,6174,106,130,2008,8525
30446,12,273,3,37,95,420
41884,1005,0,75,109,553,1742
31547,22,53,5,49,100,229
16606,27,2539,7,47,189,2809
2484,177,1327,164,196,1190,3054
2616,42,2719,29,52,894,3736
12497,20,231,6,36,120,413
5279,749,42159,429,246,8514,52097
19731,13,197,5,37,144,396
4884,7420,57066,6335,6928,38418,116167
163,229,4349,245,479,1705,7007
50088,2,52,0,3,14,71
45055,14412,36879,1896,2697,33573,89457
1760,417,8577,190,173,6213,15570
39551,70351,461841,6429,4309,143200,686130
190,870,69332,617,501,9661,80981
6277,58,523,74,176,462,1293
12833,22,68,6,51,150,297
33803,490,2513,273,918,1699,5893
3755,22,536,10,58,272,898
37431,18,316,11,48,208,601
33826,8,22,3,44,40,117
5395,72,363,51,77,605,1168
48575,18,99,5,26,125,273
9136,3570,86570,2566,1624,19911,114241
35134,468,3623,241,215,11618,16165
2781,116,977,104,179,1371,2747
10690,169,2976,103,79,3302,6629
39307,3,11,1,31,25,71
50739,3,0,0,0,5622,5625
5578,178,3321,163,122,1450,5234
41293,4,137,3,14,37,195
14951,138,10940,78,107,1688,12951
1690,7878,54636,6735,6151,94783,170183
4554,62,284,56,107,548,1057
9869,8,97,3,42,87,237
34197,272,1436,155,186,4535,6584
39119,7,33,6,44,75,165
3320,51,851,40,52,713,1707
40953,10,28,9,51,82,180
40022,2872,1,1010,395,1652,5930
38024,62,590,30,51,504,1237
44408,0,0,0,0,362,362
31964,114231,2222806,24755,29200,154741,2545733
49164,0,0,0,0,1007,1007
6641,65,1898,19,41,912,2935
33157,1301,17197,754,342,10698,30292
31361,20,52,4,82,180,338
29978,62,13278,29,108,660,14137
32144,38,115,6,44,201,404
3659,22,273,18,52,235,600
21041,18,2045,11,39,279,2392
5212,604,3181,310,269,2020,6384
33876,16,191,12,46,192,457
9098,50,718,48,105,891,1812
16345,34,340,14,44,282,714
2448,572,16035,392,275,9970,27244
4080,2153,16752,1694,1006,9574,31179
33050,5940,150895,1639,646,96837,255957
11745,891,6264,458,389,2606,10608
2528,111,1106,73,70,1189,2549
48374,49,106,42,38,229,464
24765,22926,229572,14987,16408,111365,395258
33850,3137,12145,1163,3504,15156,35105
32790,8,329,3,29,76,445
4555,357,2720,205,230,1103,4615
47122,1,6,0,11,16,34
706,299,5016,409,486,2838,9048
18479,41,283,33,105,247,709
17321,8,66,2,58,82,216
33773,13,47,2,33,58,153
39620,174,1228,77,716,506,2701
30016,23745,155880,12666,20478,73775,286544
28401,53,388,59,134,368,1002
36494,242,4813,108,144,2228,7535
13587,537,30765,317,200,10862,42681
25781,9611,358580,2962,1176,57408,429737
37168,6,47,2,27,53,135
37308,224,2547,145,146,2655,5717
49448,477,0,36,52,245,810
10271,6585,110057,3943,2337,44596,167518
19775,8630,128106,5174,7249,62286,211445
8634,1568,53634,377,564,7304,63447
31020,12,51,5,55,69,192
34532,264,2445,198,159,6515,9581
32861,10,224,0,17,46,297
6183,28,432,10,47,338,855
49109,3,0,1,0,27918,27922
45530,1,10,1,14,16,42
200,1746,10310,1632,1690,9642,25020
587,2489,57998,1723,1514,30255,93979
35030,8,19,1,35,42,105
37528,7,282,2,20,115,426
33827,7,34,2,38,35,116
12447,499,5711,592,480,4033,11315
42106,249,1639,83,80,3590,5641
6527,94,2688,68,93,1266,4209
37379,9982,57449,3248,1620,42683,114982
31101,573,3918,249,256,1438,6434
50273,4,0,2,0,16366,16372
19781,21,178,11,43,252,505
34765,40,217,24,62,483,826
33739,21,129,7,51,124,332
2321,1093,7728,809,520,13166,23316
6546,345,8624,125,460,2566,12120
11609,30,97,12,56,188,383
3239,689,1358,530,484,3733,6794
34685,8,129,0,16,28,181
29929,8,128,5,50,68,259
35576,13,62,4,53,62,194
44129,95,1297,33,75,726,2226
8197,431,19754,378,202,4457,25222
17671,28,145,23,102,243,541
650,1541,23011,630,389,16492,42063
43702,4,18,3,18,34,77
33125,707,4519,351,404,1873,7854
39926,3,94,0,11,17,125
1441,404,9087,251,207,9969,19918
49078,3,28,1,32,41,105
30305,13,90,6,72,90,271
713,692,43292,679,582,12619,57864
48790,6,65,2,37,67,177
38192,15840,20758,2545,7457,36122,82722
10849,117,4150,76,95,1807,6245
10152,915,50171,624,324,13468,65502
11213,28,150,14,94,186,472
30049,8,48,1,44,36,137
44002,2,27,2,27,30,88
1960,728,0,380,884,886,2878
6686,463,2912,265,232,1665,5537
3535,112,2005,70,123,1103,3413
35008,32,49,8,59,105,253
41500,10,135,4,7,31,187
32833,1348,9244,642,507,2844,14585
6837,24,878,10,58,137,1107
7366,74,658,50,71,1199,2052
12867,171,2292,78,52,2346,4939
29865,208,845,346,570,563,2532
22627,9,115,5,44,97,270
19773,23,249,20,66,269,627
5089,17,103,12,62,150,344
16754,9,57,2,53,66,187
37931,28,81,11,56,123,299
7314,30,484,17,62,431,1024
36904,5168,122353,2932,3067,15282,148802
40589,1,11,1,23,25,61
30920,49,854,29,57,663,1652
30217,19,237,10,36,183,485
38573,21884,106329,7966,37827,60624,234630
30764,6,60,3,34,37,140
33972,294,397,48,57,1707,2503
27575,20,100,13,101,194,428
48776,6333,7800,1089,4126,17844,37192
46157,2,3,0,11,21,37
36755,655,6545,350,279,1193,9022
30365,1650,53937,636,433,14690,71346
2956,140,809,78,89,468,1584
17325,72,368,40,113,1039,1632
38307,5,91,4,12,24,136
38368,13,125,8,52,151,349
5030,8502,88107,7454,10651,47400,162114
305,147,1952,98,156,1770,4123
5293,55,616,32,74,580,1357
30762,8,59,2,38,44,151
34456,43,67,9,123,279,521
1925,148,3149,102,95,2527,6021
30209,7,78,4,36,31,156
42837,3,51,2,5,14,75
32626,9,147,4,51,73,284
2469,143,1236,103,157,768,2407
30924,158,1259,64,73,1402,2956
30415,1572,53705,811,516,25825,82429
1261,463,5924,830,1252,3534,12003
40703,6,198,4,7,23,238
32417,13,59,3,47,59,181
35009,330,8316,161,311,2991,12109
5315,537,3615,325,246,2066,6789
36556,122,553,60,55,2325,3115
49942,292,1319,45,108,1533,3297
34941,1785,1,594,429,7115,9924
336,510,4410,636,957,5669,12182
44516,41949,1,1364,4124,44873,92311
38038,529,2844,252,211,1201,5037
8609,289,13330,144,191,2728,16682
28423,8140,34031,6308,9912,24262,82653
3654,2237,23242,1691,2659,11094,40923
35112,32,35,14,83,104,268
2739,33,229,15,54,348,679
4832,71,409,46,85,339,950
1521,176,7954,151,106,2949,11336
26279,17,207,20,52,252,548
1092,454,20845,228,213,5450,27190
13041,19,165,8,51,153,396
2032,452,3033,406,600,4162,8653
4901,8013,183529,3736,1645,51434,248357
36086,9,130,2,9,31,181
39263,1,13,3,26,28,71
12663,48,465,35,102,647,1297
19117,5350,49135,3182,4452,31605,93724
8538,162,983,105,179,1174,2603
467,19031,183559,17195,8980,130599,359364
38272,53,48,21,36,471,629
221,907,18473,409,369,7913,28071
34420,3776,14798,1308,1817,10190,31889
36116,14,176,1,15,48,254
42145,39,185,24,89,344,681
48101,0,11,1,16,13,41
2461,199,2940,79,63,2679,5960
40459,81,117,37,66,923,1224
21493,20,335,9,76,147,587
3102,858,7810,503,376,3203,12750
33939,20,101,5,21,101,248
1579,3487,61913,2914,3951,19967,92232
10553,384,4549,203,207,1476,6819
39836,877,9622,305,499,5602,16905
18561,9,355,3,28,55,450
18497,7134,45442,4155,3678,54644,115053
1606,5724,57491,5293,5098,27475,101081
37752,39,87,10,61,141,338
418,229,16031,189,121,3216,19786
48491,0,0,0,0,4714,4714
13965,21,287,17,67,331,723
24227,9607,114644,3125,1479,21897,150752
38857,23,100,6,74,176,379
38878,3,25,4,35,36,103
26333,9,35,7,44,55,150
31004,6,31,0,48,39,124
39506,2670,6216,880,1855,10113,21734
9009,523,2243,272,222,1723,4983
37051,18,369,18,51,218,674
14659,450,2613,279,200,1242,4784
2016,116,3948,100,84,2268,6516
21659,3824,149356,1432,837,27682,183131
6554,49,674,17,51,620,1411
4807,60,508,40,76,429,1113
24199,13,760,5,22,88,888
44545,7,38,4,24,32,105
2864,158,1554,84,160,715,2671
31070,245,4895,125,97,2248,7610
38876,3,25,3,40,33,104
2283,180,1463,178,266,1290,3377
32108,1252,60224,553,401,11763,74193
1391,390,2314,267,244,3218,6433
30658,363,2780,202,215,1102,4662
48791,68,243,18,38,349,716
8719,9,264,4,39,90,406
1618,249,1215,247,245,2747,4703
36051,561,3018,262,240,1154,5235
9734,1404,90661,770,370,18407,111612
32063,1164,4753,501,372,2348,9138
39993,125,3077,101,101,1621,5025
2277,152,1464,133,230,1521,3500
19165,640,6331,538,507,11812,19828
3140,168,1576,86,114,630,2574
6347,21371,411808,16114,23526,110832,583651
36722,371,157,117,154,2586,3385
1798,79,4256,63,53,1065,5516
25611,8,82,7,65,54,216
18275,14,71,5,47,79,216
1410,264,7114,231,206,2378,10193
34086,9666,92701,4583,4697,34145,145792
33570,13,133,3,53,79,281
29681,9,322,5,37,68,441
1761,242,5160,131,97,3291,8921
39675,532,911,111,214,1938,3706
6728,26,338,11,51,323,749
39783,50292,353948,8076,6039,111045,529400
41433,31444,174583,9668,10940,103278,329913
4443,120,3421,116,314,889,4860
35303,101,217,49,105,490,962
49380,107,122,24,30,430,713
1087,3091,12296,2350,1799,20940,40476
37305,554,7606,302,142,9231,17835
1627,90,821,80,86,874,1951
14629,112,3729,55,70,1299,5265
31885,1021,3329,384,286,1483,6503
26079,23,306,10,54,197,590
27601,1851,89495,955,495,22328,115124
33487,39165,524844,14161,28574,106210,712954
49505,2784,8036,506,992,13876,26194
12755,38,1180,12,35,377,1642
50284,1,0,0,0,1165,1166
43311,0,4,0,7,16,27
2460,108,3950,101,87,2054,6300
2962,331,38384,228,219,3686,42848
1149,318,4718,274,288,2576,8174
36701,9,67,8,83,62,229
991,312,3167,146,253,2122,6000
4191,136,1028,142,187,1358,2851
30376,185,3562,186,145,2854,6932
13497,16,82,9,60,195,362
3414,21,95,10,76,123,325
43761,1,55,2,6,15,79
39962,21,1012,12,25,241,1311
40489,1784,30758,430,664,10519,44155
50487,126,1,51,19,716,913
3183,37,406,18,47,493,1001
37497,25906,126165,11186,14560,104303,282120
5153,178,831,131,148,1674,2962
41011,8,383,5,12,72,480
13405,145,16398,39,202,1390,18174
36889,3130,2900,671,460,1887,9048
38526,9,110,6,60,41,226
2921,1868,18480,853,931,17632,39764
3067,116,1656,78,103,1799,3752
5356,10335,98068,8322,8086,82256,207067
34566,390577,0,93272,156928,84068,724845
15783,98,2268,83,83,1851,4383
2507,302,2429,186,192,1028,4137
5644,209,1719,142,132,1143,3345
18695,375,2334,239,224,1299,4471
2625,27,1264,22,87,401,1801
29275,8,63,1,43,61,176
6148,351,3420,134,133,2151,6189
3681,212,1319,124,139,852,2646
2993,20533,475268,12476,27685,80914,616876
18329,14,84,4,47,69,218
29740,9,43,4,53,57,166
41951,6,52,4,60,48,170
30228,12,72,3,45,74,206
21597,680,5440,374,354,2037,8885
38711,49,55,22,59,179,364
23423,2856,9512,1167,1151,8663,23349
1195,22055,559994,12192,20771,120072,735084
11177,329,4794,271,470,1048,6912
44411,71,98,24,31,550,774
31995,407,4610,250,216,1292,6775
38469,54,560,23,58,548,1243
1854,109,2204,100,111,1037,3561
37346,133,947,63,55,7195,8393
22497,26,394,11,57,241,729
20045,919,42679,471,367,10104,54540
6994,41,844,15,60,385,1345
4866,1108,56654,277,1395,3057,62491
8765,124,251,79,144,958,1556
244,425,2187,543,658,3104,6917
3876,43,280,35,88,451,897
49899,0,44,0,3,11,58
5097,776,9695,439,307,2704,13921
41568,25,365,16,55,534,995
8247,1991,158696,872,504,20662,182725
30988,404,4547,280,112,2020,7363
12029,6562,39813,3761,2052,50768,102956
6709,184,7213,140,144,2425,10106
35883,441,4461,187,244,2854,8187
40497,31438,154588,6865,8337,81288,282516
38572,23085,164894,8076,33237,58404,287696
34716,13,309,6,29,74,431
40082,478,14992,160,124,8614,24368
831,937,11795,1368,1881,5838,21819
1500,440,4909,264,319,3613,9545
32143,14,110,12,76,143,355
30705,1722,24494,795,4507,7421,38939
3729,192,1827,136,126,800,3081
22509,23,123,21,55,227,449
15699,6484,115674,3854,3914,35714,165640
10241,21,342,11,109,139,622
10666,36,1909,17,44,370,2376
40613,185,6001,55,133,1606,7980
48352,20,46,12,29,686,793
33941,16,250,4,27,81,378
10737,634,13103,575,405,3810,18527
30309,56,149,30,77,743,1055
5298,155,6720,107,161,2301,9444
48533,9,221,3,8,50,291
12021,2226,9132,1667,1614,5050,19689
6857,32,1039,11,59,413,1554
23835,30,1310,12,31,294,1677
3593,790,12533,454,323,5288,19388
8312,38,1514,25,36,765,2378
10798,6293,68865,4964,6110,53479,139711
38212,1236,8124,416,915,7038,17729
9545,525,3118,257,219,1582,5701
465,593,51746,480,285,8514,61618
30444,14,126,4,52,82,278
18283,9,68,2,52,75,206
2960,344,3218,239,175,1414,5390
1244,103,835,57,109,943,2047
43430,3,8,4,15,29,59
8669,11,295,9,73,243,631
33787,15,79,1,56,75,226
40315,284,3902,196,251,6550,11183
39650,56,99,26,77,99,357
2632,25,890,27,94,347,1383
39274,195,9627,94,162,3023,13101
22617,9,117,5,44,88,263
353,500,9550,396,381,3341,14168
2080,41,496,18,51,479,1085
43567,5,60,2,8,14,89
28621,8413,75415,5906,8787,55188,153709
9326,339,1620,199,216,1074,3448
10350,1075,16370,681,475,7273,25874
33051,9031,81156,3774,2246,20989,117196
11487,68,5503,30,39,746,6386
40661,238,6107,76,68,2190,8679
29471,14,99,6,52,117,288
45585,66,434,43,91,811,1445
9438,38,191,52,121,305,707
31111,35,1032,15,47,565,1694
40612,3,88,1,12,17,121
46985,19514,57610,1750,8814,24592,112280
8304,33,367,17,32,460,909
16790,8,54,4,47,70,183
1339,465,3263,336,460,2093,6617
31433,7244,32261,2820,3534,25677,71536
38606,74,391,35,48,676,1224
1513,157,1084,94,119,770,2224
8676,19334,173444,13078,18642,111988,336486
35277,7,28,2,35,44,116
18339,13,75,2,60,90,240
31135,11,78,7,46,90,232
38506,6,132,2,18,52,210
24785,6,214,7,43,56,326
40415,4,103,3,7,49,166
36573,10,115,2,27,62,216
27663,4608,64373,2274,1412,11031,83698
47983,1,55,2,4,30,92
41549,343,4731,92,187,2932,8285
30234,13,1140,5,47,147,1352
40841,395,23375,125,98,5228,29221
10686,665,59265,380,270,7936,68516
49396,61,1764,37,24,663,2549
3147,44,589,18,43,454,1148
4502,1081,8343,550,426,3578,13978
16187,412,2536,213,194,1050,4405
50078,4,145,0,5,15,169
199,19008,1407132,3893,1762,127545,1559340
39810,56,368,25,54,490,993
37787,66,108,34,195,249,652
8297,88,2553,48,105,1013,3807
39161,2,23,3,28,30,86
4600,1462,7096,618,594,2926,12696
2257,332,999,253,197,2706,4487
33964,458,23240,228,324,5087,29337
4544,17,74,20,55,345,511
37753,14,139,1,35,91,280
41212,303,525,92,95,371,1386
30200,9,72,2,42,43,168
34106,1681,9088,882,771,8428,20850
35618,7,43,1,37,40,128
28625,2483,33137,1011,763,36649,74043
93,5643,109514,4857,5323,27020,152357
7243,26,972,13,35,241,1287
36692,184,2226,84,88,1659,4241
5809,57,112,39,72,466,746
1812,165,2059,102,402,1531,4259
11663,315,7808,250,154,4416,12943
50147,1,37,0,2,6,46
28283,1366,8994,944,2216,7628,21148
33899,4854,22256,2178,2537,22265,54090
9540,17,106,9,70,145,347
49842,2,0,0,0,22105,22107
38106,28,631,20,39,290,1008
33443,758,687,214,200,2109,3968
48056,5,13,3,11,30,62
448,697,31226,386,248,7369,39926
49345,86,43,72,4,7547,7752
1740,87,287,65,134,818,1391
36597,27,849,6,16,135,1033
39653,401,0,178,128,908,1615
4537,67,769,36,74,612,1558
15545,66,565,56,285,348,1320
39978,60,54,17,126,444,701
38089,629,1342,387,738,2430,5526
43222,1,26,2,7,17,53
48467,665,0,209,112,321,1307
31989,637,11788,376,297,12069,25167
2934,217,324,203,202,1904,2850
31722,14566,536364,3754,5375,61741,621800
33706,4,30,2,21,25,82
19647,9171,152205,3339,1731,42283,208729
43413,46,227,30,25,415,743
6792,80,1165,81,136,932,2394
9539,3326,28454,2599,4979,9424,48782
36038,23289,267023,8110,9666,92201,400289
38888,2,147,1,11,31,192
2344,119,1280,67,106,896,2468
87,604,30735,298,198,8682,40517
31189,825,6187,361,340,1774,9487
33221,496,13219,175,162,4609,18661
1718,166,4410,138,133,2466,7313
5813,15,1666,8,46,186,1921
4350,152,1387,108,124,916,2687
8701,23,907,10,54,310,1304
5556,55,317,38,69,329,808
428,189,10297,113,95,2576,13270
9774,474,5620,183,201,2508,8986
4515,42,827,40,125,373,1407
21067,1495,15540,844,2817,9374,30070
398,407,11235,217,155,4431,16445
15809,50200,1034814,25454,20255,189425,1320148
50036,2,173,1,4,69,249
13629,144,15348,60,91,2741,18384
4907,19,288,13,71,249,640
7782,282,10283,228,283,2905,13981
50851,1,35,0,1,5,42
1090,616,25422,303,234,6381,32956
23991,145,3657,70,140,1648,5660
38326,3,97,0,16,39,155
33013,1749,15684,735,472,9292,27932
37311,86,807,31,74,786,1784
23277,32488,338889,15854,17307,160627,565165
315,79,1419,55,93,1234,2880
37640,19,41,8,44,61,173
20913,64,3019,27,83,872,4065
16419,1483,11895,1103,1483,5704,21668
39994,9,95,5,14,37,160
42484,3,113,2,7,25,150
21575,240,2771,143,144,2819,6117
19993,11,77,13,76,88,265
1658,220,3302,108,73,2982,6685
7683,15,180,7,39,145,386
43279,0,10,2,6,11,29
9638,826,6261,445,373,2657,10562
41452,3,79,3,7,25,117
4970,1234,73308,671,516,16801,92530
49785,2,1,1,0,45251,45255
42883,473,2955,136,671,1541,5776
7060,82,2822,65,104,1394,4467
1408,569,6056,391,386,2700,10102
16818,13,88,4,58,87,250
35076,17578,156026,5858,15218,64004,258684
40472,359,3908,222,191,1235,5915
36559,12,71,2,40,58,183
28619,7601,55148,4654,12451,29335,109189
8250,80,1627,50,57,975,2789
407,1510,16373,1670,1296,10790,31639
33266,85,234,28,92,416,855
24921,895,15897,449,296,11331,28868
2081,44,689,22,42,459,1256
2145,267,2860,191,231,1461,5010
35790,110207,926429,20808,34257,167928,1259629
21517,7,77,4,44,56,188
43439,20991,66794,5327,6011,60065,159188
41595,1,1,0,0,9676,9678
38648,27,121,15,64,468,695
49341,16,54,5,18,130,223
38914,5,122,2,7,25,161
20785,54673,631909,28646,55333,149450,920011
35612,15,153,7,42,128,345
32947,3473,21267,2461,7093,15029,49323
19187,15,1480,6,23,168,1692
574,161,1407,150,210,1660,3588
30975,9,37,5,45,74,170
2777,56,781,40,65,544,1486
2135,963,9908,549,430,4020,15870
41005,1,0,0,0,11568,11569
39173,3,225,2,14,36,280
1648,132,3631,105,91,1705,5664
6032,158,3340,130,129,2393,6150
33201,131,11516,61,60,1021,12789
21473,1279,52841,560,332,19253,74265
28587,10,531,7,24,125,697
36067,5,183,2,13,36,239
786,125,2420,106,216,1454,4321
1675,293,6115,287,577,1134,8406
8234,250,2750,246,379,1883,5508
30454,516,2851,297,271,1297,5232
44153,0,9,0,11,11,31
1767,158,2202,70,79,2267,4776
37877,16,134,3,27,100,280
35405,10,470,4,27,70,581
35000,1220,26293,498,261,11743,40015
36716,7,249,1,14,38,309
33728,828,10241,351,429,9936,21785
4027,343,3366,237,202,1516,5664
11255,549,8821,317,228,6625,16540
40922,798,1571,256,239,804,3668
49965,0,4,0,11,14,29
37667,12,93,12,42,88,247
16828,19,109,3,52,101,284
2214,457,6519,402,369,4256,12003
35129,17,195,11,50,212,485
5154,85,488,60,89,428,1150
21439,3213,33998,2027,2423,13303,54964
48327,1,11,1,16,19,48
11633,26532,432021,16818,21611,122747,619729
33114,11,190,7,36,149,393
6460,61,4833,35,90,591,5610
1942,314,3215,287,340,3658,7814
33886,12,393,4,21,57,487
7053,1967,13243,939,675,5495,22319
34815,6,77,2,46,83,214
1371,345,2568,360,357,4790,8420
37619,815,690,311,323,2996,5135
25975,8,345,3,40,54,450
6573,9475,282558,5995,5655,79034,382717
27849,8,43,3,53,51,158
25011,933,26209,563,392,10331,38428
22631,15,133,10,71,174,403
36822,6,137,0,10,39,192
1635,357,5756,233,228,1524,8098
43681,0,4,0,9,13,26
24459,1093,28281,403,308,10802,40887
1927,85,1493,41,57,835,2511
29871,10,437,4,32,91,574
1023,1002,42965,723,480,14865,60035
35673,310,6497,146,113,4033,11099
40474,4,172,2,13,38,229
166,4960,72074,5232,4804,33525,120595
41140,303,1298,158,33,6329,8121
24875,13,73,7,55,77,225
8184,23,142,18,85,184,452
12993,16,332,2,20,101,471
16377,23,195,18,74,225,535
43239,0,11,2,8,10,31
32188,3785,172467,1381,511,42359,220503
33549,11,260,11,41,119,442
1952,560,8468,395,360,6346,16129
23943,101,721,69,95,1278,2264
35670,6,100,2,27,34,169
28913,32,528,33,78,501,1172
39959,1292,19775,415,307,8879,30668
1216,127,6927,69,148,1989,9260
33074,212,4778,96,95,1990,7171
49769,3,40,2,3,8,56
6892,825,6222,440,343,2271,10101
9993,25,154,10,49,326,564
3378,162,785,78,118,548,1691
35021,6,19,3,33,41,102
38509,2,105,0,7,23,137
795,2601,9179,1594,1161,22780,37315
15815,14,172,12,53,167,418
44245,1,46,2,15,18,82
5938,86,608,61,124,1044,1923
6988,55,4234,73,110,617,5089
48590,5749,35757,815,518,4237,47076
29413,161,2996,110,162,1679,5108
48961,2,136,3,3,27,171
36676,4,103,1,14,27,149
40745,3,202,3,6,33,247
37686,7,31,2,40,37,117
39761,816,15007,227,197,13340,29587
3948,423,5649,267,200,4758,11297
4106,1901,90107,813,360,29869,123050
17867,1356,8644,642,459,3746,14847
7244,16,569,8,33,182,808
33687,114,2161,74,100,1292,3741
523,10237,772609,2962,1374,107783,894965
22297,30638,735205,11949,7954,131848,917594
18731,14,89,10,49,88,250
38678,43,1007,20,42,339,1451
46491,38,1256,28,52,721,2095
2738,32,144,31,77,223,507
38851,761,1719,342,1810,2948,7580
13161,15361,267229,6658,13815,67969,371032
31988,9930,122488,5539,3248,54478,195683
43213,2,23,2,7,15,49
39013,26,52,8,42,89,217
12807,14,135,8,70,124,351
35100,7,55,1,42,39,144
14513,51791,624287,33011,27112,178949,915150
37850,51,0,27,77,99,254
488,4150,38272,2717,2227,38446,85812
32864,2500,5308,911,658,2590,11967
43265,0,10,1,7,13,31
21607,25,1032,11,37,195,1300
49208,103,92,39,38,876,1148
34903,840,3071,415,935,6640,11901
50563,5,124,1,4,14,148
38174,12,70,9,27,133,251
3154,143,1491,95,115,1828,3672
36475,33024,368992,11848,28288,84740,526892
10325,737,3942,369,351,2313,7712
7845,42,215,25,81,224,587
7969,686,4722,368,307,2361,8444
8561,22,118,6,42,219,407
14913,144,897,70,173,1003,2287
49739,34,866,25,34,275,1234
10570,575,2466,275,241,1771,5328
1435,211,8003,127,117,3221,11679
36182,16,409,12,46,149,632
38020,1140,19824,506,545,10266,32281
30030,193,699,139,243,1178,2452
16642,982,7317,481,405,2475,11660
18205,126,943,97,314,539,2019
832,165,742,126,183,1509,2725
4059,2220,254840,1022,764,24902,283748
25543,68,898,44,84,695,1789
704,185,8236,191,183,4152,12947
21433,14,151,12,85,194,456
3454,258,1450,169,175,1076,3128
2445,261,3448,170,171,1066,5116
33195,39,204,21,53,289,606
32355,6190,12073,1891,1317,7056,28527
6852,14,1323,10,61,169,1577
2382,83,275,62,142,746,1308
33,25169,329059,14909,10493,137449,517079
37277,674,6200,287,435,3322,10918
33801,87,249,27,69,634,1066
28119,10,46,6,47,97,206
18835,155,1888,113,86,2060,4302
10360,40,225,12,62,242,581
8503,215,561,157,139,1547,2619
2087,160,1065,126,161,990,2502
2285,152,2832,186,527,727,4424
24893,4955,75867,2821,2382,23953,109978
40961,6336,15692,1595,6946,16880,47449
33028,12846,200683,6647,5817,51911,277904
41206,630,1647,309,180,1958,4724
4121,40,154,23,74,323,614
187,1798,121777,640,420,17731,142366
40888,88,0,43,59,390,580
1455,144,4085,107,153,1885,6374
38775,920,1425,361,249,806,3761
42981,363,1645,114,790,1217,4129
48312,3,83,3,7,19,115
38191,3,185,2,18,30,238
29099,14,85,10,86,87,282
22039,630,5135,340,262,1768,8135
19437,14,133,9,46,141,343
8722,18,580,0,30,144,772
50713,0,0,0,0,16138,16138
19519,22,956,14,19,165,1176
965,215,1806,203,320,2109,4653
40372,651,13637,431,408,9157,24284
39652,1441,34963,498,639,13778,51319
10935,176,5534,140,107,3165,9122
36234,7,43,11,46,73,180
10639,39,503,16,47,1383,1988
25113,53,971,23,42,466,1555
13947,11,176,8,75,171,441
43675,0,4,1,10,10,25
40851,12,161,4,30,77,284
30300,2546,118087,931,687,19601,141852
2585,84,2238,62,63,1351,3798
34935,8,116,2,32,56,214
33601,11,44,1,52,69,177
22669,76,0,20,103,141,340
5691,161,3603,121,78,2462,6425
37549,9,211,2,22,68,312
10799,40,3921,26,36,525,4548
24531,2611,17965,958,1126,14201,36861
9613,52,190,64,192,441,939
47978,1,7,0,10,18,36
36970,6,44,4,34,25,113
42364,3525,10651,1088,892,9680,25836
40103,10,33,4,41,80,168
18773,14,63,5,54,81,217
32296,17,544,3,28,74,666
38601,173,1311,64,100,2133,3781
5917,35,351,13,28,301,728
32601,2019,18290,1385,3065,6442,31201
14207,39,258,30,79,238,644
7255,15,592,10,40,212,869
750,383,4817,426,671,3763,10060
4033,195,5187,143,160,3638,9323
1681,784,24618,441,293,13833,39969
10258,711,7361,475,512,3157,12216
34096,13574,148245,4144,2790,89995,258748
6505,368,16249,245,259,6038,23159
4451,106,901,60,72,990,2129
12897,29,124,24,117,231,525
10807,755,6849,1052,617,9164,18437
43219,1,40,2,8,19,70
5868,15,1174,7,36,135,1367
47778,185022,329939,3823,1166,179004,698954
32847,11,198,1,18,63,291
2264,81,2462,42,87,1099,3771
35433,36,262,13,59,268,638
50689,152,0,28,21,255,456
3660,181,738,130,157,1284,2490
37769,411,2028,250,1143,2673,6505
25719,153,7370,82,74,1891,9570
39228,3,44,3,36,39,125
35788,39578,681526,10621,8937,98019,838681
41946,75636,9,4409,6607,75596,162257
40850,1013,2873,465,1597,3574,9522
38848,3,43,5,28,42,121
29791,9,186,5,48,88,336
6187,302,19904,241,146,5769,26362
39362,29,521,25,47,299,921
28591,19,531,7,43,102,702
17551,122,3058,140,173,2429,5922
25977,5,337,5,39,55,441
29369,14,52,8,63,59,196
44086,26,1208,8,23,174,1439
39549,4,231,1,15,39,290
8557,8554,101798,7524,7974,53334,179184
1251,3097,20442,2788,1745,28694,56766
21863,12256,155887,5935,8841,68006,250925
1422,116,3616,95,103,2308,6238
38022,731,773,226,322,2670,4722
31362,85,182,46,75,1717,2105
10074,137,4361,99,109,1900,6606
37928,65,135,17,40,242,499
31978,65,1684,43,85,621,2498
15971,10,60,7,35,131,243
3202,56,1459,89,245,652,2501
2990,97,750,62,99,459,1467
29795,10,122,4,41,67,244
11717,27,1450,19,38,410,1944
5177,5041,76932,2099,1432,53098,138602
1832,183,2785,113,130,1925,5136
42804,48,0,19,37,332,436
14317,119,5207,52,45,1289,6712
49599,0,1,0,0,4506,4507
31145,252,4993,307,279,4093,9924
32884,10,61,4,58,69,202
27413,731,2925,310,234,1748,5948
6891,360,2813,236,178,1214,4801
48847,2,54,0,2,14,72
8743,49,1738,17,40,630,2474
485,404,6430,468,595,2563,10460
9506,96,1636,54,73,957,2816
20951,25,837,9,29,309,1209
28585,5,61,5,68,49,188
49005,6,153,3,12,22,196
5079,7654,49845,6573,8463,40882,113417
30138,19,54,4,42,91,210
33161,4065,176016,1078,644,26906,208709
9903,13,82,3,60,62,220
4232,293,7398,196,189,3094,11170
14213,26,186,24,121,217,574
5640,63,443,36,77,534,1153
39616,3,126,1,12,23,165
43282,0,8,1,6,12,27
40078,6,97,3,21,101,228
1032,132,3945,83,71,2717,6948
33462,1218,10571,688,2497,5725,20699
28861,524,9207,292,600,2795,13418
36130,31,55,9,47,150,292
2817,190,4302,128,214,2127,6961
39182,14,171,1,18,47,251
32484,737,5201,319,481,1351,8089
37843,3,309,8,49,112,481
21507,8414,115253,6234,20253,37661,187815
33867,30,87,7,48,104,276
31500,5740,48440,2967,4686,34031,95864
1067,1885,16375,1508,2397,12560,34725
1986,91,439,62,120,756,1468
38870,2,28,4,28,34,96
38530,53,2010,67,73,793,2996
23933,56,1241,54,98,684,2133
49520,1,0,2,1,47941,47945
773,162,1645,101,128,2070,4106
9650,27,343,15,37,257,679
498,240,2567,160,146,2872,5985
40359,9864,32128,3466,9444,42068,96970
38714,60,750,52,70,1694,2626
38072,5,112,6,41,41,205
32039,666,6773,326,508,4356,12629
3446,310,29790,116,119,2973,33308
2213,1993,12875,2481,2071,11586,31006
5053,144,2441,91,119,2868,5663
24913,709,35352,341,186,8341,44929
41820,6,99,3,4,17,129
32762,5,219,2,15,41,282
5563,50,427,34,86,386,983
19811,58,643,32,45,458,1236
17269,765,38942,313,290,9043,49353
49026,762,2404,338,71,10313,13888
24315,12,192,3,27,48,282
992,511,10587,461,539,4303,16401
5673,61,777,46,68,944,1896
40701,4,199,3,4,37,247
49782,0,0,2,0,25492,25494
30166,51,509,27,45,468,1100
10076,1165,46037,570,536,8287,56595
34307,13,196,8,33,127,377
8142,3470,95719,1597,900,70993,172679
31884,1404,3848,871,831,4255,11209
34843,20,89,10,50,110,279
38673,325,2906,117,404,1892,5644
2715,57,1175,33,52,1078,2395
39566,9,138,0,24,48,219
388,1240,12898,977,1109,7153,23377
35454,8,91,3,26,61,189
41481,5,122,1,8,34,170
41417,4,24,2,21,37,88
451,1098,76300,604,328,12850,91180
43348,0,2,0,7,13,22
56,643,8203,733,1310,5648,16537
7266,516,4399,265,244,1558,6982
39068,518,3000,199,205,995,4917
22467,11,241,5,41,77,375
6202,33,425,14,67,320,859
30420,19,313,21,47,269,669
38830,14710,125580,2489,10021,26946,179746
10924,672,7979,324,280,6160,15415
33759,42,178,10,66,156,452
33895,6,22,4,28,40,100
17717,130,6263,81,89,1790,8353
43538,0,5,1,8,10,24
7617,10,496,3,38,78,625
225,12179,479216,8747,24224,31916,556282
42090,29,34,8,90,131,292
26081,65,207,31,102,261,666
48703,4,18,1,20,95,138
32149,13,121,9,63,127,333
46283,2,6,0,12,17,37
845,4386,36811,4514,5399,21709,72819
29952,12,620,6,27,87,752
18823,10,163,4,39,92,308
39846,218,2906,104,94,3620,6942
36639,211,0,60,155,573,999
30814,10,254,7,32,71,374
29854,18150,110853,11296,13585,50508,204392
50060,1,0,0,0,555,556
1278,243,17785,216,177,4948,23369
37405,4332,5871,1464,902,3404,15973
24403,55,43,17,134,200,449
48013,1,4,0,10,20,35
42865,5,161,2,10,43,221
41396,1666,384,545,240,1216,4051
25095,8,36,3,44,50,141
18247,11626,282805,6115,10899,40759,352204
30401,9,227,4,29,44,313
25329,11,53,4,59,90,217
40900,47,1074,12,29,274,1436
38043,4,162,1,10,31,208
29473,13,48,2,59,52,174
12467,13372,149558,7959,14439,72675,258003
38061,239,7617,118,118,2356,10448
22381,58,535,42,137,409,1181
36981,18,58,11,49,72,208
1831,88,1351,52,51,993,2535
50634,1,0,0,0,893,894
30667,12,238,4,38,78,370
40630,159,3107,55,61,1520,4902
2758,90,395,65,131,530,1211
32158,35,389,33,88,509,1054
50139,0,0,0,0,3237,3237
3884,42,536,36,39,429,1082
37884,363,12948,213,100,7273,20897
14379,581,4195,329,236,1724,7065
18331,11,84,4,47,71,217
10779,8788,30704,2955,2021,11315,55783
30328,9,316,3,37,66,431
4946,152,1430,89,129,728,2528
6707,14372,392981,8472,11371,80945,508141
39047,8,28,5,28,26,95
47307,22,1534,18,27,235,1836
43005,3,59,3,7,13,85
49221,17,60,5,53,112,247
8635,131,2848,99,94,1877,5049
48481,311,375,99,118,3160,4063
39923,4,100,0,10,17,131
28775,30,956,10,43,315,1354
1991,260,2263,213,330,2196,5262
37590,215,3384,109,208,3869,7785
14617,308,6137,162,131,4149,10887
6733,53,738,45,60,772,1668
22411,9,328,6,35,77,455
23661,23,183,9,46,187,448
4392,21,746,8,56,167,998
1432,155,6188,114,111,2935,9503
9952,32,152,17,64,268,533
35730,352,1897,159,1183,1898,5489
10536,1118,28300,845,375,12777,43415
26449,804,24946,475,678,8062,34965
21427,289,2471,182,393,1782,5117
35707,18,433,5,27,136,619
33857,15,37,3,42,68,165
4385,59,1258,42,77,673,2109
36995,93,1167,51,89,1191,2591
34611,94,5872,53,104,1153,7276
40515,4884,80871,2289,5756,32751,126551
40893,281,1988,68,274,1319,3930
50586,0,0,0,0,328,328
38181,39,2081,10,55,389,2574
6408,1597,33397,875,699,26447,63015
2523,739,4485,488,651,5248,11611
42838,3,58,2,9,14,86
35786,6,180,2,29,33,250
2313,155,6250,82,139,2189,8815
37106,1271,9882,439,1295,6886,19773
21525,13,119,4,49,108,293
21069,844,8849,431,370,2076,12570
50501,116,0,6,16,62,200
38681,223,1964,85,113,2509,4894
31424,192,1163,119,118,671,2263
1534,562,6180,558,522,3653,11475
2361,221,2677,239,319,1484,4940
49691,1,0,0,0,6794,6795
38871,5,24,4,41,41,115
35104,7,33,2,40,72,154
19433,11,114,5,65,88,283
25157,30663,539941,13580,24722,124336,733242
28197,6,225,1,33,42,307
2700,63,543,55,83,517,1261
38699,2539,81192,1089,616,29067,114503
46213,1,4,0,12,17,34
33087,197,499,126,116,2887,3825
8651,242,2571,140,130,912,3995
2085,46,409,28,52,493,1028
11061,298488,1507270,112805,45886,311788,2276237
7164,12,418,16,31,196,673
38960,7,232,1,14,38,292
14675,101,1296,74,87,1368,2926
4558,138,981,88,116,511,1834
3482,52,783,41,77,774,1727
9591,338,8456,328,449,5867,15438
37338,3174,11568,1846,4304,15017,35909
3475,89,3245,35,53,1611,5033
43357,0,7,1,6,14,28
76,3599,50379,3027,2803,35552,95360
30903,51,2638,30,57,617,3393
35654,56,1956,19,59,459,2549
14093,1046,47511,888,1493,6916,57854
15979,127,2302,101,169,2433,5132
33985,8435,44800,3799,15341,24289,96664
3963,107,2088,120,130,1987,4432
7264,500,2405,263,237,1637,5042
40305,713,1010,280,158,745,2906
5347,466,9791,236,277,2174,12944
36401,7,90,2,20,34,153
43556,0,0,0,1,10963,10964
35331,15,37,2,35,56,145
5684,866,7195,759,759,4772,14351
32269,9,80,2,52,58,201
33906,11,187,1,23,44,266
9667,24,811,7,24,220,1086
9356,44,755,15,49,353,1216
28311,749,6765,395,331,2338,10578
29921,8,203,3,46,61,321
15807,281,11974,171,172,3732,16330
5542,37,329,28,94,269,757
14127,1099,7451,534,406,3026,12516
10324,135,1283,98,166,1220,2902
48317,1,9,1,12,18,41
30242,1117,3402,416,318,1821,7074
33188,22,43,4,107,95,271
3515,628,30796,405,257,5030,37116
39995,566,5026,179,96,5308,11175
19315,5298,106648,2850,19017,36965,170778
39144,2,13,1,33,26,75
4066,1109,7319,1002,1647,7211,18288
13469,1612,141669,833,359,21691,166164
38285,60,406,22,40,609,1137
40416,2078,38336,781,262,40131,81588
40273,7,29,2,26,39,103
22137,41,539,13,30,406,1029
38968,4,136,2,9,33,184
48849,38040,63547,8128,10232,89114,209061
48954,27,51,8,11,946,1043
41494,1,21,2,18,35,77
43796,1,5,1,7,11,25
30886,16,470,8,36,179,709
9754,259,8751,192,132,5260,14594
1451,109,2575,52,97,1229,4062
6375,80,837,76,129,885,2007
45684,1,6,0,10,18,35
50881,4,80,0,0,10,94
25375,68,4120,38,74,734,5034
13821,15,101,14,73,148,351
5172,516,4309,321,240,1714,7100
38107,898,1010,299,211,1077,3495
5587,67,370,44,65,301,847
4814,4065,143926,1780,2091,14110,165972
2036,210,1545,286,297,1334,3672
39206,3,104,2,16,43,168
10545,94,2580,54,84,1055,3867
8152,36,350,36,68,428,918
1360,573,4997,325,315,2475,8685
40383,4,106,1,16,32,159
10232,2432,14324,2041,2231,21603,42631
7229,95,965,78,116,1302,2556
18083,17,225,4,45,117,408
5084,302,6284,189,114,6680,13569
3231,1954,32496,2279,3092,17036,56857
21591,23,601,14,41,233,912
17813,270,8901,143,148,2353,11815
3432,86,667,74,126,605,1558
3306,77,1801,37,88,1176,3179
19685,10609,105562,5813,12788,41663,176435
11235,5274,106568,3253,3127,32872,151094
23115,212,3629,198,173,3472,7684
9095,27,466,9,46,239,787
39197,7,138,3,28,64,240
49638,608,1831,40,50,506,3035
29665,7,216,7,38,67,335
39538,447,1014,192,71,2877,4601
39474,0,0,0,0,180,180
49983,0,0,0,0,87,87
25301,16,51,5,50,145,267
35455,30,44,5,56,69,204
16067,32973,270232,23959,27884,188487,543535
5308,92,1554,58,96,1135,2935
10257,1306,9612,1017,1371,6093,19399
37895,72,682,30,45,441,1270
4278,301,1913,195,167,1131,3707
2736,64,1461,104,241,399,2269
7248,123,3714,73,88,1943,5941
11679,42,5486,11,73,655,6267
38733,542,34859,278,124,6527,42330
42848,626,1838,219,190,1062,3935
19431,183,3512,76,86,1295,5152
48102,1,6,0,12,15,34
9502,9,800,4,31,108,952
1621,47,1111,49,52,690,1949
35418,420,2763,167,159,3203,6712
33501,9,92,0,33,53,187
35545,21,85,7,57,98,268
11561,25,599,9,40,328,1001
18041,3514,40374,2892,3517,21194,71491
30901,9116,48641,5207,7201,28395,98560
967,12343,37908,10415,6259,47749,114674
1018,678,9013,587,622,5514,16414
1580,83,876,48,63,891,1961
43374,0,3,0,8,12,23
42876,31,0,22,21,107,181
34021,1260,16663,342,207,14211,32683
6979,2264,13277,1449,2841,9888,29719
1585,96,1019,41,100,893,2149
8679,9,199,5,38,57,308
33478,12553,96297,4112,6051,53827,172840
33950,1130,25583,356,515,8702,36286
21981,14,39,3,65,62,183
23433,588,8314,305,516,3599,13322
21179,55,741,23,46,529,1394
48904,2,23,1,17,43,86
50480,5,87,2,8,50,152
50318,3,40,0,1,5,49
5262,4464,71552,3417,3872,12443,95748
11771,57533,766939,30465,27600,143043,1025580
20709,8623,64223,4814,6241,57079,140980
49103,9,487,3,5,30,534
32888,47,518,25,63,723,1376
5918,130,2454,71,78,2043,4776
43367,0,10,2,6,12,30
2704,210,1149,250,267,2240,4116
37994,2998,25895,1130,1461,45982,77466
30938,7,28,1,40,49,125
6422,283,1831,204,166,1394,3878
36834,113,559,51,62,1180,1965
45834,1,6,1,10,17,35
4824,69,333,35,76,325,838
34136,2427,58782,1279,755,52980,116223
35530,7,106,1,18,27,159
43455,0,5,1,6,10,22
14183,24,211,16,72,276,599
40312,7,727,6,15,39,794
50919,0,0,0,0,1741,1741
49507,441,272,94,92,2476,3375
34656,12,404,3,29,74,522
23283,44139,651951,22998,19574,257441,996103
376,1665,152237,995,691,23533,179121
39587,87272,593978,17484,10205,186276,895215
3976,295,2289,163,182,1004,3933
13421,12,484,5,27,111,639
29551,9,273,5,42,81,410
3167,5658,90254,3219,1660,67167,167958
43690,17403,138732,5540,11344,56134,229153
36085,7,136,4,8,32,187
37142,88,0,34,43,72,237
36649,63338,324732,30845,27310,230697,676922
3936,35,503,24,96,386,1044
40392,8290,52303,3314,4253,38410,106570
2429,56,1665,29,69,826,2645
4400,112,741,64,91,483,1491
48377,8,442,8,11,54,523
27961,9,21,4,52,48,134
42446,5,27,4,28,47,111
2785,71,562,36,49,983,1701
41068,32,320,22,38,592,1004
2973,95,2794,57,65,1479,4490
35478,146,0,37,208,772,1163
41341,962,13738,283,475,10718,26176
34449,1698,5608,1071,8049,11854,28280
42070,18,68,8,32,125,251
34436,11,155,8,52,104,330
48641,9111,6777,1341,1417,12280,30926
30931,8,31,2,61,43,145
13217,490,2402,214,171,1162,4439
39619,248,4442,131,134,4624,9579
45618,107,112,44,133,1380,1776
43274,0,12,2,8,10,32
35503,5656,27242,2936,3529,29742,69105
21033,9928,134152,4215,8942,38340,195577
43370,0,5,1,9,10,25
26013,9,253,6,56,53,377
5322,59,569,38,95,439,1200
42436,7,195,5,5,21,233
1896,1065,8932,583,531,3723,14834
2322,173,1887,95,115,1988,4258
2125,225,7323,190,171,3906,11815
43755,188,92,135,27,8541,8983
38587,6,160,7,23,67,263
45302,1,7,1,14,16,39
13693,32,348,10,46,260,696
43433,2,61,3,21,19,106
18989,241,5576,142,146,4602,10707
1791,228,1993,130,206,1043,3600
42977,225,3727,54,91,825,4922
39625,4,16,1,29,28,78
16458,22,139,6,60,203,430
42834,22,30,12,33,151,248
41877,462,2692,150,85,6671,10060
40839,53275,548498,13252,27238,107220,749483
34655,12,730,4,23,95,864
41689,9,166,7,24,76,282
326,1386,36595,912,934,18835,58662
3922,227,1057,120,135,904,2443
45815,3,14,0,11,28,56
32807,15,163,9,89,62,338
17113,58,3080,40,93,553,3824
39103,1,10,2,29,23,65
10369,11,82,3,47,88,231
40591,78574,742237,15374,7958,162520,1006663
38533,342,1431,109,107,2371,4360
50251,130,932,67,50,632,1811
6630,18,159,6,71,170,424
46317,1,8,1,13,17,40
46309,1,16,0,9,21,47
30064,10,102,5,54,101,272
21781,585,8717,148,102,4237,13789
50845,19,58,5,12,165,259
26313,8,57,5,52,71,193
16514,27,197,12,61,305,602
4905,31,179,21,93,322,646
37176,406,4520,88,149,1010,6173
23911,11,58,10,83,91,253
2825,203,4302,193,378,1162,6238
33242,983,18413,435,466,9057,29354
42625,16526,61850,3004,4310,57500,143190
40971,107,2056,32,76,787,3058
5468,15,100,11,62,167,355
2435,207,1751,137,174,1008,3277
11275,32,212,22,114,305,685
13823,13,142,10,55,115,335
6479,297,18045,160,146,3846,22494
32407,10255,68417,4682,17733,43051,144138
31302,28,155,11,30,163,387
4927,57,425,28,58,578,1146
5403,124,794,74,96,453,1541
8909,242,4313,174,103,2486,7318
21373,740,17201,420,384,5370,24115
41280,10,124,3,26,75,238
42460,5,65,7,37,87,201
10361,78,1411,64,92,1500,3145
49709,2,1,7,1,83308,83319
50706,49,39,23,10,1514,1635
8178,27,431,19,44,411,932
50285,197,0,35,83,1675,1990
44062,211,116,67,64,939,1397
3627,697,17760,581,625,8667,28330
43345,0,9,1,6,8,24
2780,120,1876,58,74,1400,3528
6880,40750,789580,27042,35822,207151,1100345
35176,8,38,5,42,48,141
29745,8,49,5,51,57,170
41116,3,22,4,25,31,85
50863,0,0,0,0,189,189
37109,150,4387,82,76,2639,7334
37140,9175,4097,4577,8220,18873,44942
49982,99,20,42,18,1431,1610
49118,48,0,13,30,211,302
33531,3957,11288,1837,4591,13839,35512
2236,11033,528506,4007,1858,162609,708013
10683,1475,9648,676,598,3850,16247
10039,10,144,7,47,100,308
31177,17,108,3,89,132,349
21339,4116,162366,1882,850,71589,240803
39138,4,24,2,33,33,96
30358,77,1511,28,40,759,2415
37047,529,5524,239,155,5676,12123
48456,686,21067,186,197,6900,29036
26323,11,40,3,41,48,143
13759,55484,771202,32023,30038,217058,1105805
31618,114,987,69,69,616,1855
6978,44,781,23,55,641,1544
6984,238,11667,207,164,3642,15918
40730,9325,39589,2089,1828,33071,85902
33103,141,2139,76,68,1120,3544
14511,2347,31603,1445,1076,16574,53045
34259,11,41,4,36,70,162
38007,13,17,11,53,68,162
24451,473,17227,207,128,4702,22737
20961,72,1548,38,56,945,2659
7259,17,718,9,45,203,992
42910,3,59,1,3,15,81
23579,1390,6410,816,906,3355,12877
2923,11040,122830,10736,15768,39972,200346
16199,384,13838,255,250,3705,18432
3937,21,165,11,86,107,390
40460,368,6616,149,105,7149,14387
23611,7,69,3,54,57,190
36423,54,357,21,75,228,735
21019,12,57,4,55,64,192
31240,121081,1437343,39959,44896,223475,1866754
4541,129,1080,64,108,550,1931
957,6187,38642,5283,4338,32767,87217
1400,141,5615,148,95,2436,8435
52,1817,34477,2729,2961,12109,54093
5548,87,646,51,150,477,1411
10967,38,196,14,64,339,651
12857,311,5065,198,178,6182,11934
36395,9,164,0,16,34,223
2719,261,1269,347,1211,1426,4514
127,786,11547,976,1247,6004,20560
49392,1389,90,261,303,434,2477
3230,4931,63402,3298,5018,34320,110969
42014,5,168,2,19,44,238
20479,581,22624,287,215,7322,31029
3941,426,2605,235,199,1343,4808
35952,66,481,47,77,986,1657
37336,8,133,0,16,48,205
29800,8,152,3,48,49,260
34963,1041,7217,465,314,2097,11134
46040,1,3,0,11,17,32
36104,13,275,0,35,72,395
40342,5,75,10,50,100,240
4363,278,2617,167,167,916,4145
2033,210,3504,131,144,4566,8555
34427,2848,11396,1316,4081,11116,30757
1420,121,3473,99,87,2030,5810
37514,2153,40450,793,890,42174,86460
40206,1217,43526,503,205,11025,56476
36301,9,99,1,19,38,166
39201,4,110,0,10,25,149
37657,1446,3855,622,2349,8441,16713
15769,103,877,67,70,960,2077
20877,129,9972,75,107,1574,11857
29503,8,169,6,42,50,275
38903,0,0,0,0,1819,1819
43627,2,80,1,7,18,108
608,143,3895,103,96,1757,5994
30397,8,237,1,27,56,329
30767,8,90,7,64,90,259
38433,76,752,61,103,942,1934
50346,9,1,4,2,36988,37004
30095,19,197,5,60,101,382
35328,87,641,52,111,1195,2086
33756,78,73,25,46,670,892
123,5627,58262,5927,6437,30850,107103
35528,14,66,5,39,66,190
50470,0,0,0,0,898,898
10847,34,213,20,63,364,694
36451,25,780,8,14,173,1000
42842,3,83,4,9,21,120
8753,36,223,21,104,210,594
36443,12,77,4,26,79,198
43490,1,11,0,4,11,27
32388,9,103,2,49,53,216
38387,2,103,2,12,28,147
33887,13,149,1,18,39,220
5760,1011,5585,724,806,8376,16502
39588,179,533,67,95,762,1636
971,843,12149,1174,1778,4298,20242
6682,7795,157133,5643,11973,39678,222222
36578,16,223,4,36,127,406
32385,30,325,7,27,243,632
19991,12,83,13,87,89,284
3312,685,8523,923,1457,4581,16169
16576,120,2343,94,165,1793,4515
29431,32,18,12,81,94,237
2100,87,1527,69,59,1139,2881
19953,724,4973,539,514,3923,10673
47405,1376,1,122,170,2369,4038
18521,21,101,12,38,126,298
19251,449,16412,242,285,7550,24938
39877,5,131,1,16,35,188
822,737,35905,320,242,6454,43658
37494,7,25,9,45,69,155
10199,38,259,22,51,304,674
8539,60,264,25,76,700,1125
36641,9,128,2,17,67,223
43671,0,11,2,4,12,29
34755,8,79,10,48,94,239
41090,8,609,8,10,99,734
31658,4088,190961,961,553,40045,236608
48208,1,11,1,16,21,50
897,637,98213,337,292,5646,105125
19365,8490,47653,7776,13059,45746,122724
44224,7,210,4,6,25,252
29429,56,43,30,83,84,296
48875,63,42,27,28,1199,1359
49766,0,0,0,0,2466,2466
48082,0,6,0,9,11,26
819,733,30839,336,465,7890,40263
34884,866,10937,374,248,9074,21499
11553,1983,134955,986,642,23091,161657
14623,13,86,13,60,104,276
1510,250,2474,148,160,1086,4118
1387,904,6103,568,765,2883,11223
18713,564,21880,311,148,6436,29339
10259,937,17989,404,303,17424,37057
226,42681,989503,31371,46248,242881,1352684
2544,227,3012,183,220,1786,5428
839,78,1229,50,55,784,2196
37680,25,245,20,38,252,580
8078,482,8495,328,269,3148,12722
34156,34,117,8,103,223,485
37414,23,82,3,19,42,169
28073,8,52,3,54,80,197
50039,8,293,1,5,16,323
37281,4613,24607,1282,2488,15235,48225
43787,1,61,3,6,16,87
1974,1849,13409,1545,1433,16652,34888
37609,11,230,1,15,50,307
37927,10,41,7,39,93,190
9385,38,327,15,54,312,746
25591,38,273,18,38,293,660
18307,21,107,4,61,118,311
4664,242,6283,191,184,4232,11132
42632,266,6473,120,75,2760,9694
43768,3,70,5,6,14,98
36317,9718,47435,5215,7384,30437,100189
1089,941,25395,429,293,14147,41205
29856,6,191,1,26,30,254
36063,8,154,3,16,36,217
22561,26,120,11,54,157,368
38877,5,25,5,36,42,113
41296,15,268,5,16,73,377
17959,34,447,25,69,434,1009
23245,12,99,3,56,87,257
35858,14,202,2,23,70,311
45583,2,55,3,16,37,113
1344,117,2092,83,123,1428,3843
2171,328,34833,204,185,3380,38930
12499,59,3296,37,88,554,4034
3964,99,1974,107,129,1916,4225
1705,75,709,69,153,730,1736
5167,89,503,79,81,980,1732
1289,334,4145,202,116,3976,8773
8294,408,1792,247,182,1590,4219
33704,62,170,30,85,437,784
7718,58,1177,43,62,1416,2756
301,242,3163,292,443,2468,6608
18121,779,22673,425,382,4414,28673
40377,12,147,12,33,255,459
7858,1616,82924,676,487,15942,101645
38999,370,19478,193,100,5918,26059
9801,16,488,6,25,166,701
2660,36,2003,30,79,434,2582
48081,0,4,0,12,14,30
37555,2764,7614,1081,2407,17979,31845
11141,63,449,32,95,374,1013
987,590,59636,310,383,5552,66471
72,6037,217305,4748,3867,41858,273815
23701,1059,43614,701,637,13087,59098
39321,4,206,4,7,41,262
40531,3,147,1,18,30,199
36620,13,87,8,46,113,267
36455,2873,9707,910,1257,13648,28395
35215,42,117,16,37,152,364
24647,19,187,5,68,143,422
1567,878,8889,982,804,6083,17636
40854,897,5532,201,184,2103,8917
37999,85003,1003737,26654,23058,197636,1336088
5614,94,415,49,74,381,1013
49559,0,0,0,0,19184,19184
36662,18,55,8,39,159,279
2866,890,8213,518,441,2920,12982
38693,408,9193,210,245,5480,15536
3989,91,1101,40,39,1189,2460
26271,8,40,3,44,61,156
601,1122,43818,465,338,22425,68168
39471,1594,2189,602,335,1566,6286
33119,169,2804,79,99,1786,4937
48843,787,1177,235,148,582,2929
43316,2,10,0,7,20,39
790,34327,238095,29805,21422,234792,558441
24121,15,70,8,43,78,214
35617,9,69,3,29,58,168
35684,18,154,5,23,141,341
17151,11,353,3,20,50,437
37964,5129,25796,2100,6285,18114,57424
37998,5716,31326,2122,6611,23725,69500
7411,3052,31751,1300,1100,9029,46232
45537,1,14,0,9,15,39
40378,4,166,2,10,22,204
1381,67,2038,54,89,1238,3486
36721,927,2418,382,296,1554,5577
11441,965,15869,648,421,7165,25068
2182,612,9565,331,181,9826,20515
36003,15,61,5,49,55,185
41824,309,1153,134,125,457,2178
33387,18,68,5,53,81,225
48586,3,77,1,14,17,112
33770,54,784,16,35,378,1267
50384,0,0,0,0,1190,1190
34630,19,82,5,42,75,223
41401,114,281,26,137,549,1107
30124,9,87,3,44,86,229
35891,717,1985,281,261,960,4204
31637,19473,391286,7383,7386,57073,482601
2176,120,2179,109,119,2091,4618
19185,30,2082,13,31,255,2411
8375,57,285,72,135,385,934
33084,7,59,2,54,33,155
42281,4,103,1,8,31,147
10735,63,960,63,91,922,2099
43986,1,23,0,18,22,64
2385,288,29473,252,239,4750,35002
49112,104,0,69,32,213,418
25547,11,96,5,42,64,218
38612,6,69,3,41,43,162
8,700,7672,793,1163,3779,14107
2560,233,4245,148,154,4654,9434
46654,0,0,0,0,4149,4149
2901,60,984,34,76,709,1863
13263,1331,21025,1207,975,10154,34692
28961,834,10624,427,350,3074,15309
27843,6,59,5,43,60,173
9015,22,178,19,80,175,474
531,650,49304,330,287,7715,58286
2690,56,890,26,54,742,1768
43492,9,226,7,7,55,304
43218,2,24,2,6,16,50
2959,163,1231,90,126,802,2412
8685,19,98,13,97,118,345
7329,52,1669,31,72,738,2562
31001,6,30,4,44,50,134
9325,144,570,83,124,711,1632
20329,340,3173,184,580,2580,6857
43416,36,18,14,103,245,416
42948,9,24,4,43,80,160
18149,44,2706,27,34,357,3168
48610,98,188,41,64,621,1012
2721,130,811,85,105,710,1841
36362,6,92,5,17,27,147
48510,7,18,5,28,60,118
2538,49,513,40,61,537,1200
8957,12,173,8,39,89,321
17313,9,84,2,55,85,235
17505,5992,40489,3203,4567,28238,82489
4383,38,832,28,57,499,1454
13251,96,2495,87,77,1160,3915
25801,348,3484,272,192,5631,9927
23053,18,461,8,28,227,742
33049,6447,215203,1803,879,82244,306576
33981,715,3995,405,262,2084,7461
38453,835,2110,316,187,1204,4652
39487,245,5141,136,91,5384,10997
40320,650,1786,172,912,4157,7677
22451,13,215,3,51,110,392
39181,5,130,0,11,29,175
48889,224,3009,132,162,715,4242
4752,8156,284925,5068,8174,32292,338615
42203,84305,419938,14050,8027,134201,660521
753,338,2891,231,223,1483,5166
1472,518,10531,337,263,6296,17945
40587,48,713,35,60,1159,2015
19961,27,227,27,105,247,633
32757,9,198,1,18,45,271
37699,726,7007,400,402,1785,10320
6028,44,739,32,62,545,1422
42723,293,2981,108,215,2770,6367
898,797,120265,357,293,5757,127469
39296,3,146,1,9,21,180
20027,22,123,12,84,211,452
2514,197,13328,129,135,2267,16056
22583,179,2170,143,107,3910,6509
31575,23,137,10,56,145,371
4550,1766,23403,1821,2647,12694,42331
40298,463,8019,186,268,5665,14601
48960,8,102,2,9,44,165
30723,10,66,5,56,80,217
35416,55,336,28,46,1239,1704
627,3092,60215,1980,1596,23801,90684
455,1285,8347,1358,1238,17753,29981
11161,492,22132,266,171,5034,28095
48350,4,17,4,24,30,79
43237,0,11,2,8,9,30
19951,2241,110685,1156,652,32946,147680
28063,1952,36024,1449,1849,15546,56820
9902,16,60,3,36,65,180
22417,17,359,4,36,88,504
9736,5892,84710,3626,6670,32421,133319
45816,1,5,0,10,16,32
1719,716,47264,535,394,8841,57750
40807,719,19580,209,308,5003,25819
42234,3,141,2,20,54,220
34100,2204,48403,865,521,28941,80934
36982,882,3422,450,770,2236,7760
41727,3,67,0,10,15,95
24633,15,289,4,25,99,432
17068,27,1470,12,23,256,1788
39219,6,129,1,9,30,175
34625,29,292,13,44,143,521
15455,21,641,7,44,205,918
35202,288,3089,136,148,2857,6518
13663,10386,248105,5041,5756,60876,330164
7654,173,4182,146,185,3431,8117
2661,49,5327,84,99,527,6086
19729,14,77,6,41,101,239
40180,63,1138,9,42,490,1742
10370,638,33398,396,725,2868,38025
50762,43,181,8,10,316,558
37616,0,1,0,0,30687,30688
32885,14,76,4,35,89,218
10196,812,19479,296,276,6743,27606
31510,5,132,0,23,41,201
12799,24,90,13,64,326,517
42012,17,356,5,11,118,507
10429,239,2310,160,210,969,3888
23555,38,99,34,91,296,558
10417,1018,36330,414,576,16060,54398
24365,492,24330,327,136,4204,29489
3507,39,2923,13,34,526,3535
28603,134,2329,131,171,1986,4751
48971,3,141,3,9,36,192
42885,48,49,15,30,247,389
48899,14,20,6,25,58,123
11507,252,7823,146,166,2861,11248
48415,1,0,0,1,23797,23799
2609,363,1263,236,265,3048,5175
37348,3795,120711,1299,749,51107,177661
9893,1006,6504,830,872,4464,13676
36264,7,205,3,16,29,260
681,61,1207,30,43,607,1948
37897,393,22204,158,190,5597,28542
1861,226,10433,172,157,3409,14397
43460,0,6,2,7,10,25
35040,6,29,2,41,35,113
35505,16,199,6,17,132,370
43526,0,8,1,6,9,24
42600,45,1249,25,18,413,1750
902,594,98541,342,266,5712,105455
35131,16,60,4,53,143,276
5341,14449,314465,9966,4927,97871,441678
926,116,1513,122,137,758,2646
21961,11,117,5,65,83,281
37885,27002,3,7014,14001,14410,62430
38179,196,655,91,112,2754,3808
32324,104,1546,45,95,898,2688
2487,88,637,78,93,729,1625
30263,13,297,4,44,127,485
5504,1226,11689,829,825,8779,23348
23309,11097,106666,6411,16536,50135,190845
22487,19,239,4,52,127,441
2272,43,889,37,70,763,1802
331,590,3709,639,592,4137,9667
35020,7,24,2,32,34,99
31687,20,1796,10,46,238,2110
150,19610,174619,22020,21753,108921,346923
3839,49,292,24,75,413,853
294,514,4950,477,901,4642,11484
544,324,6340,143,96,5407,12310
48580,63161,131459,10410,10834,118406,334270
39891,4,90,0,13,19,126
48537,422,887,95,66,1796,3266
49241,653,8720,188,188,5482,15231
48051,0,4,0,11,13,28
34497,24627,305470,5672,19995,58729,414493
6840,13,785,7,46,123,974
48512,31,121,10,22,225,409
34376,439,6408,218,200,5784,13049
39623,9,726,4,19,60,818
48945,6,367,2,5,47,427
42627,25018,52565,5035,14043,44444,141105
34167,295,1806,109,90,4214,6514
37608,8,442,4,14,63,531
22819,177,4519,81,160,2053,6990
38763,6,184,3,9,40,242
17479,13,123,6,52,116,310
5200,175,1501,120,198,1121,3115
37993,12918,82084,5071,8454,62129,170656
7192,40,652,25,50,600,1367
4657,1290,6164,1174,1825,5161,15614
9154,61,813,58,53,837,1822
13793,13,679,6,40,95,833
29994,39,194,32,67,242,574
50168,1,6,0,6,11,24
35307,10,67,9,40,87,213
48041,0,4,0,9,14,27
49948,100,917,63,74,240,1394
29772,24,1218,16,32,282,1572
43544,1,10,0,5,10,26
18771,584,2210,499,1755,2495,7543
38177,94,866,60,70,1042,2132
33279,22,132,8,37,96,295
31324,1045,44615,436,255,8322,54673
22135,14095,176748,8578,6699,125484,331604
8367,59,2998,41,102,578,3778
36357,7,127,3,33,53,223
40521,1445,3454,553,343,2004,7799
1481,94,2400,74,81,1359,4008
25669,349,1357,155,144,841,2846
821,562,25028,272,287,6231,32380
36368,20,409,8,20,149,606
16934,2676,166184,1122,805,30100,200887
7808,26,221,23,104,256,630
7160,135,460,75,126,1139,1935
34187,8,24,1,38,39,110
34978,843,6067,391,410,2144,9855
39780,15,558,5,18,125,721
40313,319,17855,131,74,4352,22731
34519,28,273,32,82,380,795
1909,127,2893,54,110,1500,4684
3762,45,380,26,43,427,921
10882,120,172,57,70,1539,1958
4078,123,4114,89,66,1782,6174
1345,89,2306,44,122,1255,3816
741,772,37748,174,487,3884,43065
17102,10,67,5,57,115,254
38422,1285,51255,438,317,9746,63041
39762,11,96,7,46,101,261
2092,46,554,18,42,500,1160
16782,12831,554969,3712,1230,160309,733051
45169,54,57,17,49,152,329
38618,3,39,5,36,93,176
2602,1683,20365,1206,1500,11549,36303
19133,340,4553,239,489,2037,7658
5306,1349,17588,833,505,9847,30122
31402,302,2196,69,127,2098,4792
42896,3,59,2,6,17,87
7465,2581,67710,1263,581,43559,115694
20965,87,5506,45,44,1269,6951
41633,2,100,2,15,18,137
259,421,6346,338,373,3421,10899
19059,11,98,3,40,78,230
2230,187,1854,221,281,2079,4622
35933,35,316,8,38,170,567
18271,16,125,5,62,116,324
37730,8,118,2,19,69,216
5289,37,686,34,63,444,1264
41851,106,175,59,69,100,509
37487,3681,14686,1732,4019,22878,46996
30430,6,213,1,22,50,292
49684,5,95,2,5,14,121
50606,0,0,0,0,2388,2388
2007,144,1032,108,119,689,2092
42068,22,19,8,96,209,354
48337,1,7,2,25,25,60
15487,1404,49560,777,488,9062,61291
33344,11,236,11,50,149,457
8130,33,243,33,86,292,687
1631,199,7269,169,200,3987,11824
37940,1778,14648,630,2032,8129,27217
36057,6,91,1,21,24,143
347,335,3533,365,491,2529,7253
1022,300,4187,312,367,3628,8794
2042,285,5661,140,98,5262,11446
39689,862,37504,269,216,9814,48665
40620,29281,54297,5745,7931,53973,151227
2060,165,2943,98,89,2774,6069
35732,7,143,1,12,33,196
24357,453,3630,271,229,1399,5982
31000,7,31,3,42,50,133
3457,18445,420892,12256,28760,68514,548867
41480,68,618,6,30,340,1062
2614,44,668,43,88,818,1661
37198,7,81,1,22,23,134
2788,188,1525,124,161,944,2942
47413,269,1424,80,66,3216,5055
43605,0,11,1,7,8,27
38134,3,83,3,45,35,169
5107,124,1021,56,130,682,2013
3318,1054,17809,878,779,6879,27399
30199,5,239,2,27,47,320
118,192,5796,179,135,2038,8340
25267,50,527,28,52,391,1048
33239,71,97,46,34,946,1194
1954,302,9298,301,247,4116,14264
21653,1388,56859,562,480,13907,73196
33523,8,138,3,34,62,245
2263,243,13877,109,135,2076,16440
49318,1677,28122,287,296,7189,37571
8675,23514,258056,14348,15624,132304,443846
5559,54,257,36,69,276,692
37547,7,287,0,18,47,359
38922,2,220,2,16,43,283
24669,16,93,3,73,99,284
38995,947,3771,431,306,1748,7203
33371,2089,12349,1455,3180,9757,28830
33792,11,60,7,48,69,195
28993,18,594,9,41,229,891
36775,599,1665,231,322,4231,7048
2522,62,1216,40,67,828,2213
12725,243,5759,117,165,3172,9456
2510,142,702,109,133,1424,2510
27497,16,109,4,62,86,277
36114,11,165,1,10,33,220
5618,129,311,153,206,613,1412
5469,26,1198,12,47,522,1805
16009,11731,108085,9264,12535,63428,205043
35054,8,19,2,39,39,107
4286,112,439,104,192,502,1349
43321,0,27,0,5,20,52
26017,9,260,7,59,60,395
2121,89,3431,59,103,912,4594
49353,1011,0,348,103,453,1915
43662,0,7,0,10,7,24
17445,16,119,12,79,166,392
17,928,14935,913,1255,4435,22466
24093,36,241,18,49,353,697
31129,5,55,5,35,63,163
39504,1,9,3,27,22,62
9221,32,415,14,35,197,693
7818,61,502,29,64,774,1430
5998,167,5275,100,123,3349,9014
43611,3,10,1,14,20,48
25981,10,139,1,38,48,236
239,11141,75923,9691,6960,117622,221337
29808,1298,8175,604,424,3756,14257
31927,488,4249,162,129,4804,9832
10936,119,2039,72,64,1365,3659
39997,4,206,3,18,41,272
2656,67,5458,46,109,561,6241
40793,17,131,3,21,154,326
5928,51,425,25,30,452,983
24327,413,1577,202,188,1081,3461
43607,0,13,1,7,10,31
35082,614,8491,352,282,14985,24724
1019,909,9818,803,1254,8730,21514
4720,5512,40513,3805,6255,53168,109253
2352,460,4334,311,334,1831,7270
31777,70,685,22,88,768,1633
26225,10,33,2,42,55,142
35037,9,52,2,36,44,143
21861,56,3328,23,55,840,4302
35847,19238,129576,8294,13222,85561,255891
423,113,2050,106,93,1019,3381
48617,4,220,4,14,61,303
34248,11,33,4,30,68,146
18295,3146,65972,1910,1913,14422,87363
2755,145,2358,86,150,2215,4954
25503,23,86,11,86,140,346
10718,35,379,25,30,417,886
6072,15,182,14,76,195,482
37930,11,189,0,17,58,275
50053,3,107,1,2,19,132
33305,167,362,39,97,562,1227
37771,534,1900,232,163,876,3705
15127,109,1035,48,77,1453,2722
8560,1391,21783,673,775,6955,31577
17707,62,392,56,133,698,1341
42829,90,217,38,43,1335,1723
35367,15,64,3,31,99,212
33547,16,169,15,60,164,424
9205,1202,4561,629,668,2164,9224
48250,25,0,8,46,64,143
1965,3356,54884,3161,3233,30772,95406
33558,1406,44344,475,369,11530,58124
100,1775,36162,1587,1862,16609,57995
36302,6,125,2,24,36,193
49284,15,129,3,22,167,336
49198,2,20,5,9,35,71
2787,8801,216942,7675,6635,49862,289915
36810,8,77,1,20,23,129
1542,443,2905,425,624,4569,8966
5547,62,325,50,89,335,861
988,79,331,59,99,1001,1569
34952,2,271,2,11,33,319
43249,0,11,2,6,10,29
36560,1227,23523,602,432,11854,37638
15617,542,13556,503,179,3892,18672
50647,200,0,13,22,197,432
49120,0,0,0,0,497,497
47955,0,6,0,12,13,31
42506,767,2668,230,460,5033,9158
15059,5193,83689,2170,1104,24538,116694
27465,8,172,7,55,61,303
12651,313,3296,247,292,1348,5496
911,134,4189,126,96,1974,6519
35365,8,54,4,38,44,148
14407,1946,71347,762,535,29756,104346
3909,33,200,30,94,304,661
2589,276,14292,276,185,5672,20701
8162,56,531,28,42,558,1215
35473,99,1539,72,84,1308,3102
32819,11,104,8,83,55,261
493,232,10004,135,131,2946,13448
32405,1169,5305,515,358,2338,9685
40695,4,106,1,10,21,142
1385,205,2318,132,153,1104,3912
8460,3839,173582,1553,1901,30096,210971
2761,213,3668,88,128,3799,7896
49752,10,91,10,19,47,177
31128,305,9030,184,222,3237,12978
1639,6647,135467,936,11318,10584,164952
4155,2953,181096,880,634,19944,205507
24701,12230,115165,5727,2756,95245,231123
6511,91,1244,78,155,761,2329
39889,3,135,0,16,18,172
23003,13,68,8,100,114,303
21545,16,90,8,45,158,317
30960,16,83,4,47,128,278
1944,520,7835,306,360,4089,13110
12115,3012,156341,899,731,26438,187421
5576,120,1083,84,97,599,1983
49970,0,4,0,9,14,27
20379,494,4323,299,216,1586,6918
11737,3283,190453,1637,780,48787,244940
41182,75,615,77,72,1125,1964
49760,187,761,84,72,442,1546
32026,159,8654,86,126,1992,11017
32979,12950,74555,9149,8953,67112,172719
19977,53,660,50,96,758,1617
9518,26,115,18,61,300,520
11021,5692,46749,3434,5416,26707,87998
27887,296,5797,197,107,2254,8651
24751,608,28046,302,234,7687,36877
1317,150,5394,108,137,2372,8161
10373,44,426,36,47,456,1009
41942,4,8,5,17,40,74
3685,21,2594,11,53,329,3008
12403,5801,121075,3481,2698,33660,166715
10090,390,6585,241,232,7085,14533
39705,6760,62884,2348,876,30357,103225
2291,269,3568,150,154,3147,7288
610,923,11381,984,1739,7326,22353
28853,95,3274,92,124,1434,5019
1283,78,2411,77,86,1159,3811
22441,18,211,18,63,222,532
32264,43,1125,22,56,387,1633
38906,17,649,6,22,194,888
3245,83,1197,57,58,962,2357
40683,8,417,3,9,59,496
15937,31,321,25,61,340,778
17481,22,257,5,49,148,481
40527,4,106,3,9,26,148
37435,29736,128848,16403,15061,93254,283302
15613,5394,54455,3857,5329,36773,105808
42801,4,81,1,6,21,113
48112,2,7,0,12,18,39
10511,51,450,20,54,566,1141
21421,1408,5876,1024,2513,5273,16094
28991,17,265,5,31,104,422
4069,198,6072,256,408,853,7787
2479,132,1668,74,113,937,2924
29487,12,51,4,58,80,205
722,104,3798,70,117,1615,5704
1763,145,1268,73,106,716,2308
20977,389,30878,242,111,4536,36156
2629,26,1052,25,83,345,1531
31549,176,754,150,707,578,2365
31965,50,286,26,98,384,844
36748,8,36,4,40,58,146
34823,3313,18492,1190,6542,10690,40227
32920,15,73,4,43,115,250
19479,28,216,23,55,286,608
34032,123,1271,66,111,2440,4011
24627,2513,65649,1400,815,15666,86043
41546,17,0,6,37,45,105
9970,664,5003,366,332,2358,8723
38628,1998,11594,1084,2576,9419,26671
38050,325,3705,150,138,2270,6588
43997,1,21,0,19,22,63
986,599,84754,294,260,4642,90549
40030,3,57,5,40,40,145
2732,44,352,35,100,276,807
30092,10,445,3,34,43,535
17981,14,118,8,42,118,300
5,5364,242765,2382,937,73265,324713
22483,15,190,3,45,111,364
34340,7,67,3,32,40,149
26295,8,34,3,46,60,151
16417,19142,187268,12557,12095,136014,367076
39581,109,465,40,214,335,1163
31952,17475,138730,8250,9476,88033,261964
36719,10,132,1,19,59,221
7016,423,6537,347,290,3520,11117
8475,613,17448,334,375,11428,30198
38874,5,23,5,40,35,108
173,2241,16224,2501,2388,15252,38606
40619,3,84,1,8,22,118
38685,30,93,8,45,129,305
3218,128,2736,125,105,1776,4870
1260,207,11630,136,123,2608,14704
36397,4644,12650,2239,4730,17955,42218
38905,6,219,1,16,34,276
35110,1505,41414,568,498,19412,63397
43633,0,6,1,6,10,23
8176,22,321,12,65,188,608
48258,1,3,0,11,18,33
34690,10,124,3,28,122,287
9167,139,2238,107,138,1305,3927
32346,14,420,13,42,142,631
37465,4,115,2,22,33,176
42995,4,86,2,5,18,115
4703,99,2881,78,112,1477,4647
42343,15,85,13,20,203,336
34506,658,882,289,296,943,3068
8074,39995,1065958,19463,41475,152618,1319509
24847,46,651,26,35,388,1146
36765,9,170,1,8,42,230
35645,288,2772,169,146,7474,10849
20671,154,3493,73,57,2825,6602
5878,34,446,21,49,598,1148
23619,693,24541,318,168,6767,32487
39003,31,41,15,111,263,461
42161,2524,1,840,210,1187,4762
29649,10,211,6,41,59,327
9748,24,203,15,52,299,593
42955,83,113,35,47,719,997
13299,41,325,19,51,345,781
47775,0,6,1,18,12,37
39539,17694,70426,8478,17621,55566,169785
1868,397,3464,332,507,2951,7651
3545,1051,5702,1177,1242,5814,14986
23191,16,117,26,116,109,384
29647,12,202,5,39,58,316
39591,497,5936,246,137,4924,11740
22605,13,145,6,50,103,317
33550,13,219,15,59,143,449
33548,12,348,13,48,130,551
5571,40,311,29,84,247,711
39564,10,176,2,32,55,275
37751,13,80,7,50,91,241
47997,0,5,2,7,17,31
154,14676,232035,12914,14940,58061,332626
1239,2782,80045,2189,1337,18086,104439
560,417,7316,246,189,5890,14058
38378,23,233,5,43,59,363
40660,21,219,5,38,132,415
12445,17710,205522,10341,9557,115622,358752
6124,17,131,2,61,118,329
45558,69,744,16,47,389,1265
2776,103,1291,56,106,1155,2711
1265,75,1586,43,69,924,2697
5943,17,129,8,76,195,425
36506,44,0,16,78,98,236
39245,3,116,2,13,25,159
17395,216,4987,94,112,2735,8144
6695,32,630,20,52,334,1068
37959,492,24455,228,105,7421,32701
17909,8621,59164,5897,5719,72496,151897
35936,1264,13670,655,508,3296,19393
19547,26,112,9,65,88,300
3362,34,141,18,54,514,761
42172,3,63,2,24,47,139
5734,3752,38155,2420,2855,18650,65832
40554,63,150,41,52,3114,3420
10327,336,2581,194,191,1156,4458
3940,492,2976,290,197,1893,5848
38352,4,72,0,20,43,139
3799,21,864,7,51,175,1118
44012,1,18,1,21,24,65
37474,1648,3274,616,439,2283,8260
36388,9,109,2,27,30,177
22647,10,93,7,42,86,238
1130,178,4520,117,109,3295,8219
32827,16109,187533,7702,11270,75910,298524
40178,1572,9923,670,2389,5621,20175
19753,12,67,5,40,73,197
31378,1839,49248,764,336,20829,73016
30534,8,220,2,29,57,316
696,2979,43004,2339,2196,19344,69862
22565,13,205,3,50,106,377
42031,648,4488,270,286,1524,7216
1086,1088,9299,842,867,7852,19948
20811,28,3520,6,43,327,3924
32107,12,136,8,47,177,380
35759,458,573,230,70,19377,20708
12603,38,770,6,59,207,1080
44145,0,11,0,11,12,34
38955,5,200,3,18,48,274
30896,140,3046,105,104,2170,5565
7561,164,1903,106,303,810,3286
13093,614,29365,331,215,6932,37457
39098,3,125,2,15,29,174
48672,36,232,38,45,302,653
39716,5,212,2,18,37,274
38017,60,683,23,72,538,1376
32804,7,616,8,37,83,751
48231,3,21,1,18,32,75
33113,1767,4836,813,4421,7708,19545
25389,1275,138475,355,319,8762,149186
4574,46,227,30,98,378,779
45770,1,4,0,12,18,35
3058,363,3688,225,257,1932,6465
705,56,1472,56,51,696,2331
33489,47642,316488,30497,26054,136376,557057
16317,460,9511,243,1035,2253,13502
42880,17,317,18,20,254,626
2791,48,1119,15,44,488,1714
40434,6183,13542,732,427,30055,50939
2082,58,608,39,53,702,1460
31793,1278,13979,602,1641,6697,24197
42141,1418,311,441,246,839,3255
42862,1152,4621,313,630,3991,10707
21995,31730,550749,15151,16046,165934,779610
48027,0,4,0,8,13,25
137,2561,88951,1005,914,20520,113951
17667,21,115,25,87,221,469
42033,8,25,2,25,56,116
12037,21,275,9,50,199,554
1406,381,3042,212,221,1163,5019
1268,100,1534,102,102,1449,3287
7785,23432,137478,13966,8583,196149,379608
30812,615,6687,319,316,1831,9768
242,1402,24593,1105,1117,11595,39812
29973,8,380,7,31,104,530
9811,21,110,10,62,133,336
24127,44,1013,19,31,600,1707
36800,2771,13234,1261,1428,10897,29591
26119,10,46,3,43,72,174
3252,31,418,12,52,291,804
33681,264,3510,161,129,3322,7386
6635,714,3877,382,327,2166,7466
4962,175,1971,302,570,1349,4367
2304,73,1625,65,129,1100,2992
26269,12,39,5,47,116,219
2034,22100,324843,16272,17125,132440,512780
38961,5,334,1,15,32,387
38556,148,208,59,79,1278,1772
35624,73,349,16,45,638,1121
35780,436,1223,176,173,846,2854
33948,7939,35012,3964,7098,41021,95034
37987,10868,184652,3495,853,200659,400527
3061,81,793,88,102,1087,2151
27709,101,1863,66,68,1345,3443
5485,883,5460,770,830,6039,13982
40329,34,484,25,52,703,1298
36136,18,987,7,15,162,1189
1741,49,1015,41,56,507,1668
46949,1,7,0,10,17,35
39414,59,116,41,46,642,904
19635,474,2042,247,189,932,3884
32294,36,3444,11,75,222,3788
17467,65,152,63,116,465,861
31578,805,4037,408,2319,3173,10742
6273,14,71,13,43,235,376
34711,7,57,2,37,42,145
1583,957,7451,818,1421,8057,18704
41722,2,72,3,7,15,99
10177,188,2189,159,276,1750,4562
11917,630,26055,263,347,5842,33137
1440,90,1635,54,77,951,2807
47954,1,4,0,9,15,29
2851,38,888,30,57,506,1519
34467,966,17662,377,614,6100,25719
37145,7,135,4,30,59,235
42590,16157,52908,3792,5179,45913,123949
40508,7,151,2,17,43,220
4521,21,312,18,53,234,638
30330,9,257,3,44,68,381
43270,0,4,1,12,11,28
49964,9,420,3,5,41,478
34209,3229,21498,1204,2728,15500,44159
47267,1,4,0,12,16,33
31056,1024,21730,585,393,9260,32992
42870,55,0,20,116,373,564
37781,973,17524,407,398,5304,24606
5018,32,167,24,63,336,622
37936,3012,15296,621,385,19852,39166
9337,64,361,28,49,935,1437
5859,112,2373,80,85,1968,4618
25049,57,244,33,107,200,641
49228,126,1153,34,51,601,1965
37698,5,43,5,41,49,143
3264,66,458,39,75,665,1303
5507,7620,61934,5823,5917,42786,124080
11617,43518,1002198,19027,43972,125703,1234418
2537,55,485,47,103,755,1445
24637,43,435,21,47,342,888
27369,7,80,9,71,71,238
40816,4,184,3,11,41,243
35890,15,64,6,48,98,231
38640,2,111,3,16,30,162
43584,1,11,0,8,11,31
39754,60,40,17,38,154,309
23209,6436,38215,4357,7585,43816,100409
36934,12196,25099,5599,7899,12655,63448
6684,21,373,15,37,232,678
45604,997,20478,309,122,9066,30972
10077,25,221,12,46,210,514
38958,451,11016,182,163,3189,15001
321,576,7613,495,974,4114,13772
16602,17,1888,9,59,176,2149
15905,92,361,32,106,583,1174
19671,2798,47156,2311,1068,14957,68290
34013,284,1811,143,363,2157,4758
1196,320,3961,290,352,3662,8585
35024,7,16,2,33,35,93
48606,14,399,7,16,98,534
50055,11,365,1,7,44,428
34358,14,86,4,52,108,264
22547,7249,63550,4667,13251,27661,116378
3849,50,889,35,49,734,1757
28377,35,94,20,51,1068,1268
32448,19,256,11,75,83,444
8745,30,314,16,44,322,726
22477,13,178,8,45,114,358
35077,43,613,15,45,520,1236
4719,5665,39991,3627,7533,29913,86729
3466,504,24664,336,171,9461,35136
49798,0,44,0,6,19,69
14047,445,2058,254,188,1375,4320
28577,7,26,2,42,41,118
4126,21,443,11,44,308,827
34699,11,124,0,16,82,233
30998,6,55,3,54,42,160
22847,195,5760,132,180,2888,9155
34858,13,147,1,14,35,210
44304,0,0,0,0,27879,27879
32271,10166,41373,4186,18723,50953,125401
42481,768,6395,313,169,6812,14457
36158,9,309,3,16,49,386
32023,5456,30626,3344,11924,18562,69912
4689,57,2033,33,46,1209,3378
19899,10,97,6,49,143,305
536,270,17757,212,126,3971,22336
45518,27,503,6,19,184,739
36292,8,112,1,28,31,180
36164,96,153,28,62,484,823
26189,57,748,27,64,485,1381
32881,2537,6728,1537,4045,5259,20106
37527,7,241,0,15,59,322
48043,1,5,0,12,17,35
36080,19,153,2,13,128,315
19177,14,86,5,59,127,291
2258,25,441,21,64,303,854
10759,18,129,21,106,110,384
32093,25617,225458,13104,13198,118131,395508
32031,56,1934,20,67,475,2552
49305,477,0,30,39,159,705
2664,51,5114,43,102,516,5826
34403,23892,307372,7550,26169,77655,442638
11693,21,383,6,54,204,668
41236,3102,2,992,338,1581,6015
31665,596,39169,337,143,8413,48658
43217,1,37,1,6,22,67
18327,12,85,2,67,79,245
2868,320,3602,175,199,1386,5682
12599,39,1231,19,46,299,1634
17357,84,2413,56,97,1250,3900
49235,650,26553,230,366,10374,38173
2222,977,5389,1175,1327,4182,13050
42443,22,123,12,36,151,344
36266,17351,93057,6347,15050,65350,197155
8314,29,414,21,63,320,847
11103,645,7028,499,635,3657,12464
2099,123,2116,84,72,1776,4171
36064,8230,2,1659,1021,18331,29243
335,1646,19602,1908,2072,10897,36125
48684,284,527,35,65,461,1372
9279,22,580,9,63,241,915
39914,3,90,1,13,19,126
5072,199,6194,130,124,2407,9054
26325,6,30,4,45,42,127
21881,71473,1458466,27387,78061,93504,1728891
35270,13,36,0,39,78,166
34383,8483,72846,3211,13560,41434,139534
1956,2705,47611,1939,2452,17657,72364
49922,52,126,37,25,190,430
48079,0,5,1,12,13,31
36151,12,44,4,45,68,173
31580,26451,326489,15340,28464,124946,521690
24447,13,100,3,60,106,282
9353,169,3218,132,124,2424,6067
40399,300,701,86,102,390,1579
29947,6,80,8,82,91,267
5027,206,2849,209,527,1706,5497
21997,46,381,20,114,400,961
26145,7,34,2,50,47,140
3210,827,35055,289,376,5198,41745
30332,9,537,5,36,113,700
31105,107,1936,63,98,1010,3214
391,571,13308,569,399,6873,21720
10210,17,135,24,78,209,463
30404,9,266,4,34,58,371
41913,85,72,33,67,420,677
6288,649,46238,360,230,8902,56379
34338,1855,23268,891,1763,12437,40214
38826,17530,547879,4061,1305,182982,753757
12039,36,152,24,90,434,736
5764,1160,71364,659,421,12903,86507
47944,0,4,0,8,12,24
42919,1,75,1,10,19,106
44167,3,7,0,10,56,76
1439,137,4429,116,104,2544,7330
34857,5,187,1,18,32,243
14129,952,5210,397,390,2291,9240
738,3772,20765,5076,5348,12361,47322
15951,385,12193,278,204,4703,17763
5540,43,424,29,89,276,861
42628,2,58,3,3,15,81
31599,25,96,9,65,106,301
41265,13829,28662,4481,10673,50624,108269
4025,34,691,33,125,355,1238
9673,202,1550,192,140,3105,5189
6676,1556,44461,1229,1221,10588,59055
49450,3,30,2,13,22,70
36571,43,97,16,39,225,420
28371,26,343,19,59,332,779
2069,57,669,30,38,578,1372
20177,30,218,24,68,186,526
979,157,12431,94,86,1919,14687
401,1215,59113,736,458,15787,77309
1388,338,2738,203,212,1377,4868
42486,41,368,17,55,210,691
48908,2,41,1,8,18,70
15347,52,697,24,61,560,1394
40526,6278,15285,1588,7871,14307,45329
5013,45,304,12,61,313,735
32707,77,293,44,81,384,879
112,286,3833,262,609,2974,7964
29623,13,262,4,38,97,414
4369,203,671,109,155,1039,2177
41353,76214,466547,16930,45640,117590,722921
12119,2166,16869,1591,2747,17188,40561
40145,3756,0,978,2197,7543,14474
36566,55,916,32,75,747,1825
1359,621,6698,318,364,2623,10624
38879,2,24,4,33,29,92
10564,23,119,12,48,144,346
32268,8934,147083,4850,1872,54721,217460
38803,84,682,59,89,1028,1942
48342,3,10,1,18,34,66
729,325,1004,279,235,2489,4332
39778,5,35,4,21,47,112
38071,5,119,7,40,44,215
36145,34,377,14,44,337,806
34721,12,341,4,23,71,451
32781,12,214,2,19,53,300
20587,39,374,15,63,289,780
13083,11,369,5,39,114,538
32160,105,1811,54,89,996,3055
8410,666,37745,450,774,2882,42517
8795,18966,204053,15964,15731,80299,335013
13655,16603,116422,13279,15655,105422,267381
241,5650,87381,4344,7679,28875,133929
11919,36,539,20,113,321,1029
34541,1358,58473,589,363,22507,83290
36033,925,1613,361,298,1435,4632
44048,17,31,6,34,119,207
13499,16,97,8,81,121,323
11341,801,9805,709,651,5307,17273
48117,1,12,0,8,14,35
2434,176,1212,110,123,766,2387
30207,9,96,2,43,44,194
8554,42,474,27,77,512,1132
26113,12,57,3,54,43,169
10949,152,2117,153,160,2921,5503
10540,47,177,44,90,566,924
29323,14,346,2,30,106,498
678,677,5458,619,629,5390,12773
7471,172,6784,93,190,1643,8882
7322,667,9916,552,457,3674,15266
22327,18,109,5,43,111,286
39808,9083,38808,2104,941,45707,96643
46150,1,6,0,12,18,37
38161,7847,21045,3766,10078,33302,76038
19125,11,429,9,45,109,603
25617,8,60,4,48,49,169
34356,7,58,8,50,57,180
33245,308,2542,234,404,2724,6212
314,107,1095,100,107,1084,2493
41202,77,1906,35,40,786,2844
20857,28,1646,14,25,200,1913
9404,17,73,3,53,123,269
50760,0,0,0,0,421,421
37385,6,187,1,14,37,245
39560,4,161,2,8,32,207
37418,151,1752,79,89,2040,4111
26263,9,27,3,47,66,152
38274,0,0,0,0,1155,1155
39568,5,332,2,18,45,402
666,4412,59238,2072,2631,31934,100287
26055,27430,780650,6747,4104,70353,889284
12231,1009,93832,272,268,5511,100892
35652,38,429,18,74,377,936
11547,495,937,434,569,2713,5148
15775,3259,49141,1699,853,30495,85447
1525,175,18577,173,181,3125,22231
40550,7643,25702,2694,7735,28012,71786
785,608,15711,363,288,10635,27605
35071,10,42,4,18,103,177
11995,50,247,17,58,541,913
4487,119,901,79,98,504,1701
1807,958,10907,873,1383,7343,21464
39707,12,195,5,25,114,351
49722,0,0,0,0,12453,12453
31592,4692,93484,2080,2934,10221,113411
48171,541,214,297,35,21035,22122
188,190,1245,118,142,997,2692
13863,466,14817,269,275,9294,25121
30070,11,120,5,37,52,225
1091,408,21524,272,192,4835,27231
13515,23,293,10,38,197,561
38330,1791,4783,661,430,2495,10160
9978,50,247,31,97,407,832
10627,14,272,8,49,118,461
23699,27,88,8,43,215,381
31867,317,7383,150,122,4160,12132
16936,69,3013,42,49,799,3972
40412,7,266,0,42,64,379
121,61985,1001475,48110,45737,169272,1326579
1846,511,4303,459,430,5083,10786
972,813,19812,445,468,3482,25020
37349,62894,656608,21299,47773,121114,909688
579,1067,19688,954,1315,9250,32274
5503,22,272,17,76,337,724
35619,8,41,5,31,59,144
1209,176,4797,94,83,3419,8569
15883,1588,11362,1351,3413,7903,25617
6215,42,1684,31,51,694,2502
44615,60,44,18,34,165,321
4607,645,4002,346,292,1961,7246
4318,73,973,37,63,801,1947
23387,65,736,32,73,580,1486
2397,650,63312,285,311,5391,69949
22523,11,39,4,40,92,186
12885,40,684,26,57,371,1178
29027,2295,89581,720,672,16356,109624
929,745,2233,573,433,6295,10279
17104,9,56,3,52,80,200
37064,7,92,2,14,22,137
21999,53,378,21,124,420,996
32691,337,2132,233,365,1241,4308
40542,5170,142688,1554,927,24580,174919
10954,58,1328,30,43,662,2121
2746,251,13782,160,165,3805,18163
42083,3,4,1,4,10,22
17677,383,5326,139,82,5154,11084
459,1734,88849,507,446,10664,102200
47410,100,1644,49,63,1239,3095
39185,3,248,1,14,37,303
35174,6,20,0,34,33,93
33312,15,635,8,27,93,778
49418,7,267,1,4,33,312
30754,13,95,5,54,86,253
26031,32,171,20,71,171,465
15359,962,15088,634,418,8782,25884
38992,24375,120562,10184,13476,82103,250700
7593,18569,393884,10482,24521,70953,518409
6120,319,1573,185,191,1304,3572
37744,19367,159937,4978,32153,40123,256558
1723,1916,113927,1658,2307,39887,159695
33862,8,105,5,30,58,206
43401,0,6,1,6,13,26
16163,12,196,5,60,114,387
28067,8,203,3,37,77,328
32799,49,0,18,58,63,188
7752,28,254,13,46,196,537
6275,102,7198,107,140,2045,9592
776,346,4512,386,516,2776,8536
9204,428,8882,165,206,6987,16668
36646,54,505,27,65,554,1205
39209,5,138,2,11,31,187
30711,1367,53420,773,445,22050,78055
35458,153,1527,54,51,1272,3057
35957,28,72,12,92,225,429
36818,6,34,6,38,56,140
40295,998,15858,464,266,9237,26823
43404,0,4,0,7,14,25
2917,272,1853,179,182,1212,3698
28715,22,1020,6,23,180,1251
15437,1520,81994,717,399,14576,99206
40482,10,56,4,32,78,180
8839,87,1050,89,132,1835,3193
11203,20,105,15,64,111,315
48711,7,266,2,5,24,304
36885,4988,72784,1585,695,62406,142458
26347,14,140,5,36,102,297
1904,113,1326,76,89,1502,3106
41446,2,103,0,7,24,136
231,351,2899,345,527,3007,7129
8190,330,20639,246,137,6109,27461
7915,48,405,23,46,474,996
39255,3,18,4,32,28,85
6809,147,2149,74,97,2580,5047
21297,12,122,6,70,92,302
32582,92,275,33,188,623,1211
33757,88,87,19,69,347,610
35960,373,3691,202,104,13100,17470
48480,293,0,34,44,252,623
1141,155,3197,90,127,3098,6667
15423,17,1113,7,34,129,1300
34933,65318,919266,26490,50104,156074,1217252
47543,6,180,1,2,21,210
32870,550,18219,275,294,9054,28392
49458,0,1,0,0,83456,83457
14471,46,445,23,88,429,1031
41349,14,58,14,86,171,343
31830,17,664,5,23,91,800
1516,2525,12575,3012,4145,6077,28334
38997,3,213,2,13,51,282
32030,84,2131,16,78,701,3010
31933,54555,725626,14273,8171,87678,890303
2783,63,726,51,99,590,1529
19873,15,88,14,62,153,332
30795,3876,25008,2309,6875,19350,57418
2505,437,3084,251,212,1563,5547
15787,34,132,23,90,396,675
12917,103,1900,30,106,1485,3624
33746,795,7421,354,788,4713,14071
40715,8,173,4,6,26,217
31621,2315,30731,939,1584,11077,46646
1808,1680,27893,1740,2609,13889,47811
156,2975,41495,3472,3207,24004,75153
3620,74,1746,64,80,883,2847
10149,17,134,3,37,94,285
38680,69048,338041,29019,23840,169297,629245
44223,5,250,2,5,18,280
34104,15749,143928,5028,12601,40312,217618
36427,40,262,9,61,129,501
21161,8,75,4,59,87,233
817,465,4702,399,524,3386,9476
45528,1,9,1,14,16,41
2372,1592,12256,703,677,3570,18798
27441,5145,30566,3118,5373,32067,76269
27991,17782,193086,9756,8320,69479,298423
50225,1,34,0,3,14,52
6568,22,159,10,45,175,411
16692,68,873,36,138,543,1658
37023,2344,2420,1420,1685,7311,15180
46003,48,331,35,76,637,1127
25941,11,128,9,66,136,350
5613,154,960,115,110,617,1956
39815,13,696,6,12,99,826
8471,41,297,26,72,231,667
10005,35,396,17,59,416,923
32503,74,580,26,55,619,1354
39854,9,122,1,14,38,184
10684,12,104,7,64,99,286
42872,4,61,2,6,14,87
40139,7,210,5,14,94,330
1181,278,4140,171,148,2817,7554
10033,14396,42367,10245,12844,34218,114070
39526,661,1386,252,213,734,3246
1262,260,7278,205,173,3210,11126
5530,23028,201990,20101,19079,133529,397727
45262,1,7,1,13,16,38
33693,15,602,3,30,73,723
302,1892,17622,1361,878,20390,42143
40033,9,211,6,26,63,315
5258,8368,180649,3170,1758,41293,235238
43566,2,53,4,5,14,78
6689,432,2643,234,238,1228,4775
34615,59,1366,46,56,712,2239
34389,2309,28977,1516,1816,9143,43761
41602,35,597,14,15,247,908
1917,293,9393,240,283,3778,13987
39416,93,833,51,56,855,1888
33602,18,53,9,44,153,277
13503,14,95,8,62,112,291
3464,1989,20704,1369,2378,12022,38462
1900,53,948,46,59,546,1652
34659,928,7239,305,436,2237,11145
22471,9,220,5,39,70,343
39451,2,10,3,36,28,79
37737,139,189,36,77,377,818
34283,92,3309,28,53,734,4216
10502,76,4253,48,57,1001,5435
6637,1625,102039,1084,496,30397,135641
9330,6723,111662,4071,7378,31627,161461
30437,1589,25109,689,1543,7956,36886
16157,8309,69821,6045,8718,49424,142317
37352,25,458,9,25,170,687
43376,0,7,2,6,11,26
33310,16,85,6,64,92,263
38544,3177,13024,1332,5241,11683,34457
35480,200,217,86,141,3880,4524
47623,58,0,19,93,558,728
8855,57,494,38,61,668,1318
1753,30,1331,24,51,561,1997
25109,16,97,4,38,93,248
21483,24,76,8,62,155,325
36983,13,241,5,29,67,355
20801,2371,12373,998,638,4166,20546
10297,139,3162,120,63,1842,5326
15535,213,4700,83,79,1894,6969
4874,129,10904,125,155,2001,13314
24269,19,110,9,52,140,330
7730,1093,4755,538,448,2736,9570
39582,2277,6505,1161,3265,10775,23983
44158,0,9,1,16,10,36
15879,1769,57966,1365,1118,15192,77410
4173,159,1822,215,188,1603,3987
43360,0,4,2,7,9,22
40956,87577,330117,24901,17305,109644,569544
45862,1,5,0,13,18,37
49743,0,0,0,0,1047,1047
42989,3,106,5,7,25,146
39102,12,105,12,28,119,276
22651,17,100,7,47,100,271
22,13309,85104,14063,13695,35932,162103
1584,68,1575,62,54,915,2674
41120,45708,170809,16441,13708,91600,338266
37881,33,528,6,30,278,875
40814,772,6718,377,95,16258,24220
4933,54,408,33,89,604,1188
30860,16,1054,9,33,102,1214
4709,17,242,19,120,158,556
29855,561,1118,266,195,8994,11134
2064,99,1231,68,71,1052,2521
5415,85,1258,52,89,1744,3228
36425,34,247,8,56,118,463
38624,8,106,2,41,88,245
9435,943,7871,540,394,3204,12952
49490,7,171,2,5,37,222
35756,10940,63069,3932,5851,45188,128980
3229,5276,67452,3015,3457,29782,108982
47766,0,3,0,7,15,25
36796,833,12864,384,370,8053,22504
29926,8,214,4,40,66,332
2899,777,55658,582,304,14356,71677
23973,15,89,11,77,85,277
4339,92,756,65,170,763,1846
41168,5822,239549,1706,1315,64684,313076
38498,9,281,5,22,41,358
2798,1446,16585,692,572,5040,24335
37587,3991,14168,1344,3866,14467,37836
49728,3,5,0,9,29,46
29956,11,210,4,27,74,326
10856,17,77,7,56,94,251
39261,1,13,2,25,38,79
22469,11,227,5,39,66,348
36942,86,561,46,86,909,1688
34474,1258,4581,576,1570,8051,16036
43459,0,9,2,6,11,28
10119,10739,77714,5332,1846,22354,117985
43378,0,6,1,6,11,24
47811,76,564,40,62,519,1261
32136,24,113,7,72,107,323
43287,0,13,2,5,10,30
2423,74,1267,36,57,989,2423
18499,1344,13742,720,297,10765,26868
3829,161,2808,95,113,3942,7119
3864,67,1372,50,68,867,2424
46706,1,12,0,16,19,48
35860,36974,286551,17245,20682,130298,491750
38080,15473,109015,6175,6818,88439,225920
2903,984,3096,671,460,6495,11706
18419,85,2558,47,60,887,3637
816,417,5427,350,662,3209,10065
4700,181,631,100,116,781,1809
2670,59,8339,46,102,582,9128
1749,212,11226,157,185,2245,14025
25397,20456,371302,10104,24101,68002,493965
9303,20,175,5,53,118,371
5997,179,235,149,154,1177,1894
34740,524,4504,290,255,1325,6898
45556,1769,18453,344,210,8402,29178
34176,15788,139400,6338,11386,55164,228076
34962,673,33462,338,253,10193,44919
25013,39686,449375,22848,21599,192541,726049
28247,39,135,32,124,278,608
6520,19,198,22,99,242,580
50302,1,48,1,2,14,66
42158,60,85,23,58,410,636
10742,27,488,23,102,195,835
48092,0,3,0,10,13,26
48906,1,16,1,6,16,40
41685,2,83,2,8,14,109
13715,97,1534,37,81,603,2352
36528,51,325,30,30,302,738
5343,112,544,66,127,1047,1896
881,245,22984,215,219,2888,26551
13931,190,4958,169,161,3518,8996
10139,27,199,10,96,185,517
35734,10,207,5,17,38,277
35121,32,86,12,36,226,392
1496,211,7747,145,171,2842,11116
2286,135,6388,84,89,2293,8989
24783,9,441,9,63,80,602
1064,337,4926,275,230,3576,9344
37665,15,117,7,60,107,306
26157,13,63,6,56,95,233
8194,50,289,40,127,481,987
43746,1,63,3,7,12,86
7189,37,97,30,94,222,480
1457,1021,5627,793,755,10853,19049
2449,758,22869,462,326,12744,37159
32786,1,94,2,6,17,120
40586,46166,133950,9500,21361,63757,274734
472,1016,11564,941,1244,9784,24549
22335,114,7107,63,94,1408,8786
12665,381,16040,251,187,6723,23582
40254,1928,13987,564,1386,11840,29705
7451,18,579,8,31,130,766
13429,729,15580,441,278,9874,26902
5590,92,591,52,81,377,1193
21855,9226,274125,4404,1783,94028,383566
6489,1080,33117,571,734,10112,45614
19533,16,212,8,45,197,478
21195,861,11819,579,546,10513,24318
9500,33,118,16,40,231,438
38267,7,177,2,12,36,234
850,2710,38934,2310,4004,14151,62109
50588,115,0,10,16,71,212
4386,48,936,40,72,592,1688
5402,78,567,46,90,351,1132
36903,5402,76093,1673,2594,28656,114418
47542,7,32,6,20,93,158
5353,129,521,127,103,716,1596
15045,406,6331,259,1133,3099,11228
1175,154,1178,148,202,2036,3718
8668,614,8429,470,512,5718,15743
48032,0,4,0,10,13,27
39590,1990,7486,1093,4096,8495,23160
43483,319,2063,195,70,1974,4621
28641,10,686,6,31,198,931
37591,7,45,7,33,101,193
36542,216,1395,68,68,2416,4163
42114,1,55,3,18,27,104
26035,24,234,10,46,254,568
4280,2468,152266,1270,444,37435,193883
8183,18,210,12,87,137,464
5783,27,341,26,54,384,832
36606,61,847,24,28,476,1436
33274,965,6324,628,2104,3075,13096
607,361,1875,398,535,3411,6580
30617,282,747,158,173,3249,4609
38464,735,6133,350,378,12962,20558
37388,227,1670,90,209,1974,4170
30985,10,125,5,53,107,300
48256,2,12,3,15,27,59
40486,860,13654,329,171,7849,22863
1080,788,7425,529,533,7507,16782
8241,2307,15985,1687,5333,11842,37154
3407,3955,33549,3750,6531,30537,78322
1729,603,12555,420,338,6435,20351
32756,8,189,2,15,42,256
21681,6314,44355,4350,5859,41594,102472
38446,14,304,11,49,81,459
27833,12880,224642,7929,4188,91648,341287
43509,0,11,1,8,10,30
36548,13620,73284,6227,11384,59649,164164
39502,2,15,3,25,29,74
39900,1,125,0,11,24,161
43514,0,11,1,6,11,29
33525,20,76,3,39,89,227
19311,18,58,6,58,78,218
6281,107,1319,63,162,2278,3929
1878,227,2892,219,262,2809,6409
36587,4679,22903,1866,2246,25007,56701
37008,509,578,128,219,4795,6229
37191,7,121,1,24,35,188
2987,207,793,157,149,2208,3514
29893,999,11810,493,324,10479,24105
48028,0,5,0,11,14,30
50997,0,6,1,10,11,28
10539,19,110,13,59,163,364
3759,617,40416,448,451,8428,50360
33241,2374,37752,737,634,25413,66910
3809,114,1787,84,172,925,3082
7512,10,412,2,29,92,545
764,692,20363,676,714,3781,26226
44041,161,302,51,152,491,1157
34533,529,17530,260,221,9351,27891
27853,11,37,2,43,48,141
44213,25,68,10,29,119,251
35980,12,127,1,21,53,214
3175,44,620,16,57,534,1271
37256,21,562,6,47,166,802
32732,7,93,0,35,43,178
31507,12,483,4,34,99,632
48420,2,11,2,13,36,64
2329,208,1021,103,122,715,2169
24855,2819,12690,1891,6037,16800,40237
22503,22,114,14,112,189,451
29861,21,193,23,61,187,485
44591,38,216,27,42,210,533
1296,111,3892,64,63,1299,5429
39368,6,71,10,35,168,290
2947,68,3062,67,85,1231,4513
1663,328,3945,355,358,4130,9116
3469,146,5551,119,110,2073,7999
114,9117,53577,8631,5801,46658,123784
30201,10,128,5,27,60,230
50871,0,0,0,0,397,397
1504,121,5957,111,105,2153,8447
36348,8,107,3,22,40,180
3403,329,4799,188,193,1016,6525
16119,60,676,47,79,1015,1877
21557,4166,169263,1702,741,67127,242999
20963,12,77,9,68,121,287
3081,278,3605,267,447,1616,6213
30156,86,308,56,158,710,1318
7876,25,432,15,55,305,832
5802,82,1333,42,53,1803,3313
19271,35,392,25,60,306,818
8079,56,597,33,62,621,1369
48276,2,6,3,22,21,54
38349,52315,45440,10930,1438,44818,154941
48770,56,60,13,89,116,334
33134,8,40,7,60,38,153
34993,7,206,5,29,53,300
33326,8,1262,7,40,134,1451
29919,7,197,4,53,97,358
25667,1386,12644,611,539,3570,18750
16101,160,3033,119,131,2366,5809
9499,109,527,65,104,745,1550
9761,650,13540,192,323,4239,18944
10237,12,74,5,58,71,220
2079,76,645,42,71,815,1649
48263,2,13,3,22,28,68
20081,17,81,12,57,118,285
566,1028,12469,658,454,12822,27431
43263,0,6,1,7,12,26
45915,1,7,0,9,20,37
49170,171,140,39,58,228,636
39110,0,0,0,0,222,222
2237,202,12386,195,153,4325,17261
20005,18,108,11,85,112,334
18413,445,6539,431,436,1612,9463
4722,8779,167933,6125,7103,54281,244221
511,283,2297,245,368,2203,5396
44218,423,1212,56,122,648,2461
3691,77,309,58,89,614,1147
30187,12621,100793,8121,10818,62030,194383
30948,1841,14160,1155,4172,11029,32357
12861,15,96,6,53,106,276
8022,388,3922,519,345,4532,9706
35345,16,113,11,42,141,323
39249,125,626,65,78,2058,2952
37258,1178,5788,386,1814,3968,13134
6950,19,1825,19,66,344,2273
32716,22,58,6,48,76,210
35510,174,528,100,180,1128,2110
14007,53,636,48,112,936,1785
43991,2,24,0,18,24,68
38164,64,70,24,43,667,868
250,8560,56341,11378,12233,22673,111185
40075,5459,15820,1973,4482,20855,48589
37217,3,115,2,16,78,214
29748,12,48,5,58,64,187
17541,741,3042,393,272,2012,6460
909,409,6510,492,721,4700,12832
3016,561,19294,338,254,9592,30039
32145,17,102,8,63,121,311
36325,6,14,3,37,29,89
38814,5661,37302,1600,7309,18473,70345
35320,819,25345,373,270,10558,37365
34486,155,0,45,58,443,701
2994,4139,119527,3128,2354,50468,179616
43349,256,8565,86,134,1939,10980
949,3945,56022,2167,1242,45336,108712
16011,26345,260234,15274,18665,116961,437479
7450,17,406,5,27,102,557
5421,44,590,18,72,416,1140
34422,9,223,3,17,51,303
8403,14,152,9,75,153,403
34239,98,747,42,114,1242,2243
28103,21,208,16,74,230,549
42282,27292,71920,5014,5899,62009,172134
10965,23,127,18,73,143,384
7026,13,742,7,36,136,934
43288,30,97,13,39,228,407
32287,275,10635,89,74,4031,15104
3783,2712,162066,1290,504,38991,205563
33958,23,141,4,33,128,329
42485,30,57,20,37,624,768
31018,145,1351,91,418,1284,3289
30153,17,96,15,73,140,341
25085,15,90,3,56,110,274
48113,1,6,0,12,18,37
37149,39,56,10,41,274,420
42568,5383,12533,1658,3941,15763,39278
1405,121,1284,78,104,680,2267
37155,7,94,0,31,31,163
36002,19,57,4,60,74,214
927,166,3402,135,325,859,4887
39358,5,64,8,38,122,237
10116,52,2977,45,83,583,3740
12455,173,5101,163,129,3052,8618
8181,42,750,23,62,541,1418
41521,912,2596,304,1167,3964,8943
26453,513,1377,447,1198,1067,4602
10249,839,23791,544,345,10539,36058
1103,960,5360,662,852,7924,15758
30329,7,315,3,35,55,415
38744,181,595,38,94,1104,2012
1626,152,2252,99,113,2593,5209
2402,5935,19346,4132,2609,40975,72997
26231,8,33,3,40,52,136
21695,113,5338,101,131,1727,7410
50663,0,0,0,0,9426,9426
30061,15,111,8,44,106,284
31973,2793,28717,1188,637,13051,46386
45756,1,6,0,10,20,37
40417,43437,210796,12245,5470,102075,374023
16798,20,206,11,56,273,566
6590,1155,7070,523,512,3324,12584
7616,24,335,16,41,459,875
30941,9,27,2,52,57,147
29829,325,3756,194,144,4521,8940
4242,65,237,61,88,589,1040
6917,30,137,25,81,354,627
5608,124,541,68,89,443,1265
43386,0,13,2,7,11,33
33999,11,60,5,43,129,248
34862,37,323,17,42,392,811
45769,1,4,0,12,19,36
32627,8,31,5,57,60,161
7902,1290,37417,1046,758,15144,55655
1055,860,13881,547,661,12287,28236
32547,847,29712,358,182,11101,42200
48349,3,14,2,21,24,64
37845,10,604,6,18,95,733
29729,13,129,8,72,128,350
24973,650,7585,554,320,7029,16138
36962,1209,44037,607,329,24110,70292
3132,42,509,30,80,391,1052
48761,46475,79889,4260,11076,57722,199422
15177,125,2235,99,98,2178,4735
27857,627,10810,400,470,2980,15287
33852,0,0,0,0,35445,35445
49432,0,0,0,0,297,297
48735,1271,4244,302,215,1468,7500
29985,11,73,7,60,66,217
9563,203,9843,162,159,3265,13632
2074,60,370,66,105,592,1193
389,2207,32854,2347,2061,21180,60649
35889,11104,66403,4646,8297,47696,138146
20235,35,178,21,49,393,676
342,630,5994,582,715,6392,14313
6771,16,196,14,80,129,435
31034,21,106,6,70,114,317
35964,3405,9060,1458,4489,14868,33280
42490,22,212,22,40,146,442
2424,317,20306,298,182,5474,26577
32419,9,60,4,54,58,185
31697,7,36,4,41,44,132
4190,45,680,29,54,574,1382
34900,0,0,0,0,4741,4741
111,590,7604,765,1038,3982,13979
9451,11,143,7,68,107,336
23863,13,57,5,51,76,202
17949,848,24927,309,414,6250,32748
5447,71,1478,44,90,1058,2741
4395,20,640,10,57,126,853
39576,4073,121782,1441,603,75804,203703
50115,2,81,0,4,13,100
44006,3,19,3,22,36,83
34348,0,0,0,0,1807,1807
35251,4129,12853,1540,5472,15525,39519
23767,14,102,8,45,119,288
35376,13237,144042,6628,6901,52576,223384
30429,9,227,1,30,50,317
42354,2,119,2,8,45,176
19645,63,5238,37,100,531,5969
31701,10,33,4,53,69,169
18567,31,104,15,52,218,420
1804,383,3460,281,308,4420,8852
2626,21,800,22,79,326,1248
28925,18,295,17,78,269,677
39187,2,208,1,11,34,256
29867,9,156,4,46,47,262
16894,28632,618851,10347,6794,65658,730282
47948,0,6,0,10,12,28
36502,560,4572,263,324,3540,9259
2227,159,3199,168,271,1942,5739
1862,494,16736,288,273,7143,24934
10938,205,1823,138,114,787,3067
31925,16,283,4,26,91,420
35857,4189,15844,1769,1122,14271,37195
35784,7,182,3,28,46,266
36161,10,47,6,50,61,174
16444,996,66166,499,228,11793,79682
49153,152,428,62,40,1417,2099
6078,40,450,28,52,549,1119
38347,140,832,54,81,1616,2723
34531,6,32,2,26,38,104
34924,9,41,1,38,59,148
3992,1214,4823,569,478,3721,10805
5652,45,745,40,43,645,1518
10463,45,758,34,45,658,1540
10137,10,109,9,68,102,298
38166,3,29,5,34,40,111
14045,1332,16401,875,2032,9759,30399
33524,747,61412,401,357,13020,75937
5774,1146,36561,308,391,6884,45290
36127,63,60,27,56,165,371
29393,9,148,0,35,48,240
45916,2,3,0,11,20,36
273,1061,8188,1010,1076,12865,24200
13691,43,2973,26,30,424,3496
39066,181,1204,78,119,1312,2894
1226,371,3409,317,496,3645,8238
36166,222,1261,136,279,1142,3040
2489,1370,4012,930,707,4817,11836
507,334,25316,241,355,4402,30648
8710,31,629,14,32,208,914
17693,35,889,31,64,457,1476
34753,565,14942,224,221,5218,21170
7972,105,4228,84,87,2255,6759
3882,133,2106,54,69,1492,3854
26089,8,54,5,57,50,174
982,272,7188,294,499,3441,11694
15743,28,350,21,40,319,758
29391,11,197,4,47,64,323
48760,0,0,1,1,34834,34836
38016,15,111,8,84,166,384
891,515,48488,334,298,5692,55327
5342,4366,59462,3762,5768,22398,95756
9465,563,46926,336,223,7464,55512
18747,13,210,8,31,119,381
31812,3610,105498,1336,738,54340,165522
2110,258,4255,268,275,2358,7414
35183,986,4464,461,2401,2666,10978
31255,17,94,10,33,99,253
36339,129,1562,60,74,934,2759
630,396,4271,379,421,4423,9890
43550,2,63,3,9,13,90
33308,59,980,36,60,964,2099
37098,8,88,4,48,42,190
34262,8917,71522,3938,7165,32810,124352
6746,88029,723293,71032,51975,331796,1266125
29235,18,378,10,72,181,659
41340,32,780,15,32,582,1441
31624,10,345,3,40,75,473
20907,99,2809,56,63,1375,4402
5393,289,1210,141,178,1081,2899
746,792,40831,252,781,4354,47010
3020,55,237,51,123,359,825
48114,2,6,2,14,18,42
46704,1,4,0,12,19,36
1738,887,9009,888,1189,6709,18682
10246,8,84,4,56,66,218
1471,1171,12644,659,413,7695,22582
10114,38,330,15,61,218,662
32983,9494,84586,3151,1783,60432,159446
28077,50,2452,28,39,457,3026
36679,5,100,1,14,24,144
16363,879,4921,416,360,5622,12198
51008,9,89,2,5,79,184
1099,56,1114,32,77,778,2057
7740,422,6707,231,208,3929,11497
31704,4288,248905,1076,587,30232,285088
42359,179,472,50,45,2148,2894
50071,3,83,0,4,14,104
25253,49,117,28,43,459,696
4051,133,784,122,269,591,1899
1530,7952,158658,7329,6618,70732,251289
6625,36,252,48,126,489,951
7004,49,1499,65,208,248,2069
40222,13,528,6,19,117,683
28495,389,4317,231,202,5873,11012
5680,44454,610342,29235,29497,212724,926252
27993,16,151,11,96,142,416
2970,1915,18004,1709,2512,10943,35083
2999,49,1139,43,55,945,2231
41659,193,1950,128,79,3518,5868
39454,2,38,3,41,31,115
27847,11,44,4,42,56,157
30010,74,537,32,45,629,1317
50209,314,6661,60,62,3942,11039
39658,5,163,3,8,26,205
29437,77,2473,60,112,1011,3733
43011,2,81,3,6,17,109
13835,64,3547,34,59,525,4229
33544,15,450,16,65,215,761
43456,0,10,3,9,11,33
37967,297,7270,223,216,4719,12725
29908,7,437,2,26,91,563
8426,6444,44311,5222,4996,56539,117512
37262,450,2778,154,154,6149,9685
47998,0,6,0,15,15,36
40059,9069,66714,2230,909,40205,119127
38732,333,3809,213,197,1058,5610
39031,51,66,16,148,290,571
17259,560,36051,329,236,7721,44897
2722,217,2685,102,86,3786,6876
18313,14,88,3,62,90,257
43224,3,26,2,8,17,56
31118,572,4453,286,269,1891,7471
37816,12,41,8,40,173,274
29611,19,257,8,68,115,467
13755,35,919,21,32,670,1677
16738,54,2049,35,81,809,3028
39328,13,95,5,29,136,278
36298,52,243,23,39,536,893
23279,1553,13615,536,345,25481,41530
32855,13,240,3,18,60,334
50482,2,43,1,1,7,54
3887,103,10161,91,98,1877,12330
38000,191197,1878293,33722,28839,168168,2300219
33258,28,145,11,63,192,439
1269,312,6884,140,111,4626,12073
7651,313,2659,209,162,6347,9690
5032,388,4012,310,497,2781,7988
3448,472,4211,295,255,4222,9455
19087,19,129,8,78,106,340
117,579,9677,461,399,5883,16999
34955,8,244,2,28,45,327
41193,13,310,7,8,46,384
39203,3,149,1,10,30,193
1813,570,38079,472,257,8231,47609
40013,267,2537,133,211,2402,5550
2037,471,3085,483,469,3463,7971
42027,3,65,2,9,35,114
42500,13,144,5,43,79,284
18893,6129,81883,4091,6511,41812,140426
3609,112,1008,107,150,851,2228
11883,13,2022,5,51,134,2225
49979,0,0,0,0,1207,1207
4886,798,23329,442,336,9283,34188
1923,121,3479,98,87,2096,5881
4684,16,100,24,75,170,385
766,261,5156,171,176,3201,8965
49124,0,61,0,6,15,82
35417,833,4955,313,433,5419,11953
6783,253,6332,280,215,5749,12829
34193,7,16,1,39,38,101
36592,9,81,10,33,125,258
46305,1,5,0,12,19,37
12255,346,27700,236,187,4418,32887
7171,26,1196,14,37,451,1724
1873,150,1431,146,186,1421,3334
9998,21,118,7,51,160,357
37505,452,6600,148,193,3330,10723
36771,34,83,14,60,243,434
33897,12,39,2,45,64,162
34471,45,754,31,67,785,1682
23719,391,2260,195,164,1112,4122
38488,4,224,2,15,29,274
42250,10322,37036,2734,1874,30516,82482
45679,1,5,0,10,17,33
34332,227,1350,117,477,1431,3602
50074,5,103,1,6,46,161
42340,23063,71500,3879,8150,40798,147390
25159,19664,230769,9943,12642,100871,373889
17811,55,3413,34,51,514,4067
3822,41,181,19,87,376,704
41421,41,490,19,60,150,760
35399,12,293,5,28,91,429
48121,2,8,2,19,31,62
25117,486,3397,336,216,4836,9271
94,2516,75784,2404,2913,13425,97042
5686,389,2389,235,172,1357,4542
48438,7647,1,1700,148,34570,44066
30085,6,149,4,35,37,231
35142,33,77,13,77,137,337
38444,155,1260,61,84,1705,3265
30139,9,60,2,46,51,168
13427,134,2162,81,165,903,3445
2550,33,2103,20,44,357,2557
39260,1,13,2,25,39,80
40960,14212,37705,2918,10758,33381,98974
28825,32290,412984,17673,31334,113629,607910
48340,5,20,3,25,23,76
28155,1848,13336,1880,4622,8770,30456
35265,107,992,43,74,909,2125
31667,95,0,41,98,203,437
15839,568,4136,316,247,1714,6981
38353,6,242,1,29,60,338
37446,12304,92153,3972,18010,33279,159718
8542,101,536,67,127,1322,2153
47956,0,3,0,9,13,25
5799,23,418,8,60,186,695
31512,12,354,3,36,91,496
45523,1,7,1,12,17,38
20999,28,482,13,67,258,848
36436,109,1356,56,94,1751,3366
2592,146,4356,100,149,2007,6758
21241,2101,21829,1740,1224,7788,34682
37060,6,42,2,33,32,115
42422,42,597,28,46,1023,1736
158,2564,24115,2123,2949,28221,59972
35931,736,4184,379,328,2238,7865
30460,351,3496,231,176,1343,5597
33154,37,102,14,50,341,544
20127,25,106,15,70,158,374
3004,112,1827,72,90,1498,3599
38715,225,388,102,259,1063,2037
47025,1,7,0,13,16,37
43244,0,11,2,8,11,32
40863,2,17,2,26,73,120
29657,18,260,9,44,228,559
42345,14,100,10,43,157,324
38302,4304,18948,1961,5885,19191,50289
5772,649,30514,362,324,6282,38131
11087,33,471,23,70,264,861
14347,233,7780,145,142,3948,12248
36861,184,2178,66,95,1673,4196
2834,221,1533,248,272,2049,4323
8360,59,2988,41,104,642,3834
38140,4,77,2,52,36,171
295,283,3317,271,325,2623,6819
373,353,5583,405,424,3774,10539
25589,9,76,4,55,54,198
35272,7,24,1,39,30,101
974,1497,46651,673,577,33087,82485
10527,68,1134,37,149,666,2054
37711,975,15737,633,345,14867,32557
4447,416,36990,230,238,3679,41553
2554,179,2462,179,254,1733,4807
51051,1,35,1,3,9,49
8068,399,11912,343,331,7854,20839
5041,2800,16008,2531,3319,16078,40736
26229,8,36,2,42,44,132
6129,1521,7629,1339,1982,13587,26058
9200,64,986,48,86,513,1697
5164,60,1797,48,78,1103,3086
10705,17,111,9,63,190,390
43545,0,11,1,5,10,27
37402,799,15606,396,374,9869,27044
50025,0,0,0,0,338,338
18319,13,85,3,56,88,245
48417,0,0,0,0,106966,106966
9040,128,3422,74,112,1261,4997
41710,38935,141829,4402,8886,63122,257174
39513,7,129,2,11,26,175
45596,45,133,18,93,298,587
26307,9,54,4,50,56,173
382,1194,21752,752,935,8133,32766
39419,185,543,55,119,894,1796
36354,7,93,3,23,34,160
18343,517,7025,460,277,3583,11862
425,137,4092,91,156,1937,6413
1235,139,4542,131,97,1443,6352
1290,175,6550,129,113,3539,10506
32587,3113,20790,1180,1495,6913,33491
31310,13,600,4,24,110,751
35036,9,116,4,39,65,233
30382,1790,7314,1101,3322,7836,21363
37683,9,156,1,13,45,224
31331,315,1618,128,158,1149,3368
39305,4,142,1,14,32,193
37867,4,153,1,13,38,209
38059,16,700,6,43,210,975
26053,59,955,47,66,759,1886
41319,31,1248,18,33,220,1550
43454,0,3,0,8,13,24
35114,816,4503,452,2248,5044,13063
35317,18,70,8,67,93,256
12643,10,52,3,54,79,198
6374,111,823,65,137,932,2068
9349,31,98,7,48,280,464
14023,16,305,3,24,93,441
50694,0,0,0,0,566,566
45535,1,12,0,9,18,40
40176,468,15360,156,119,5370,21473
39565,6229,346459,1740,892,86854,442174
37729,5,215,1,18,41,280
13459,16,56,5,70,90,237
37007,11070,54011,4483,7380,25788,102732
7294,35,331,23,56,377,822
5140,21,122,15,54,191,403
20431,7817,50271,5275,6374,48532,118269
9778,457,2586,272,233,1988,5536
30825,182,10187,130,79,2095,12673
33540,84,60,24,108,503,779
31080,4613,35738,2698,5150,22478,70677
3935,94,472,74,142,824,1606
40230,4648,23018,2167,3983,22061,55877
48421,10,20,8,16,133,187
10020,2733,152595,1274,1049,19119,176770
40210,4,140,4,15,23,186
9785,206,4330,141,234,2540,7451
23483,23,1672,6,25,209,1935
2093,41,522,16,48,468,1095
37731,3,96,0,8,24,131
42794,55,217,12,42,259,585
3277,29,256,14,72,313,684
23259,2572,10763,2205,4742,7210,27492
4816,376,2151,222,182,1325,4256
37538,6,149,1,10,58,224
39158,2,15,4,32,37,90
16389,32,293,20,59,221,625
377,331,5650,217,357,3257,9812
3927,4565,110611,2523,1603,17926,137228
38101,34833,576815,10404,15217,100536,737805
2405,139,2077,108,155,1186,3665
10359,298,1330,246,347,2263,4484
4162,109,2739,80,52,1454,4434
19157,4211,7263,3500,5204,5544,25722
12429,150,3940,108,147,1866,6211
25103,8,155,4,35,39,241
31266,9,304,6,33,88,440
11285,10966,212119,9165,14579,79699,326528
17447,16,93,10,70,147,336
11769,1428,14834,776,1570,10614,29222
5022,49,316,54,102,355,876
21953,16,93,7,64,81,261
43941,0,7,0,7,13,27
27947,5346,22566,3385,1882,27410,60589
33126,47,213,20,42,397,719
39223,318,408,47,71,1394,2238
27841,9,43,5,48,56,161
9074,5975,101081,5199,4234,34497,150986
37991,72837,600496,13692,7825,101436,796286
11313,1564,24410,779,607,12829,40189
17603,27,208,3,59,212,509
34321,3918,137935,1157,904,34450,178364
44079,0,0,0,0,388,388
35851,11387,177581,3309,1179,146969,340425
46735,62,229,21,49,866,1227
43536,0,12,1,5,9,27
41812,20993,58016,3543,7794,43893,134239
23063,36,1080,15,42,442,1615
23229,132,507,77,142,1427,2285
3485,321,13016,353,249,5369,19308
6390,40,839,12,44,370,1305
1295,137,2978,83,108,1455,4761
44634,15,36,10,27,88,176
39694,15,182,2,17,56,272
4463,111,1083,60,98,505,1857
31519,1749,14707,975,2510,10498,30439
1096,776,17241,306,174,11106,29603
35840,1027,11069,371,503,6393,19363
3276,28,307,18,69,334,756
4357,127,1130,76,120,598,2051
36827,71,915,38,56,868,1948
2400,690,4930,706,643,4549,11518
32682,933,9468,467,913,5751,17532
35521,12,57,4,40,93,206
33309,596,1927,209,264,4134,7130
11697,5211,37219,4138,5994,15307,67869
34961,246,603,106,135,2725,3815
33231,1014,7078,473,390,2460,11415
1906,176,2448,102,117,2678,5521
23151,992,4587,931,2530,5862,14902
16524,13900,210222,7786,8858,67193,307959
429,227,9735,125,131,3123,13341
10497,564,16506,409,280,5233,22992
41170,5,115,2,8,38,168
32823,14,46,4,47,80,191
445,531,7989,594,716,6185,16015
27825,138,2810,59,96,1513,4616
21267,335,7710,170,401,2359,10975
20939,1287,52909,484,294,13003,67977
21829,1875,18327,816,693,4411,26122
39708,133,599,54,107,1395,2288
15313,474,6625,374,779,2963,11215
31861,478,2591,163,156,3197,6585
29799,6,162,3,45,54,270
22835,4924,67681,2220,6231,29599,110655
530,27726,204736,20898,15387,61288,330035
6893,3169,39151,1248,1388,8593,53549
29852,615,3364,299,305,1332,5915
41464,2,70,1,4,23,100
45620,107,196,69,24,3340,3736
43617,0,10,1,7,9,27
43338,0,4,2,14,9,29
20355,39,2148,21,71,437,2716
19633,273,2298,155,169,735,3630
24727,533,16438,363,254,6084,23672
42266,206,1715,36,80,574,2611
41475,2,58,1,17,41,119
37050,5,71,7,37,128,248
3833,172,1287,114,107,656,2336
42761,5,26,4,36,44,115
43772,35,52,11,35,159,292
49944,1202,3,431,128,869,2633
22603,13,269,6,66,146,500
37826,584,18741,226,127,7932,27610
50985,0,1,0,0,68,69
10801,456,4282,319,669,2216,7942
50796,0,0,0,0,2826,2826
10573,225,6959,150,142,2365,9841
34831,12,57,4,52,75,200
7751,37,124,37,78,464,740
32229,6,58,2,51,30,147
36087,7,140,0,10,27,184
36169,13,565,6,19,98,701
39089,7,148,2,12,57,226
43337,0,4,2,14,9,29
37210,32530,451031,8545,20144,81496,593746
43329,0,9,3,23,16,51
32733,16,128,6,70,110,330
50934,321,0,23,17,79,440
42072,30068,1,762,4514,29498,64843
27491,13,132,6,65,110,326
36015,4,22,2,24,54,106
1821,357,2475,234,236,1997,5299
38783,37,782,17,43,685,1564
4939,141,1043,210,297,1336,3027
43680,0,5,0,10,10,25
43552,0,8,1,5,11,25
49470,0,0,0,0,16766,16766
32775,7,192,3,22,36,260
35476,8,42,3,39,60,152
16454,42,111,23,76,289,541
48964,0,0,0,0,400,400
20787,33923,576871,18345,27733,169367,826239
36005,0,0,0,0,2523,2523
21409,111,2312,46,96,1492,4057
33031,2744,19961,1371,2760,13404,40240
7536,52,762,29,57,681,1581
3802,273,1666,151,146,1212,3448
9957,17,211,18,42,536,824
22677,360,12049,171,156,4301,17037
22249,58,1609,21,49,711,2448
36468,478,6436,240,248,2522,9924
32468,168,5168,100,131,2040,7607
8292,419,2714,257,200,1515,5105
20079,24,98,14,82,153,371
842,670,5906,386,530,5092,12584
25875,279,3208,180,300,1715,5682
1849,54,424,43,63,587,1171
30842,61,982,21,37,469,1570
37922,118,860,57,79,1243,2357
48962,398,269,59,53,1924,2703
18277,37055,367029,21193,32241,118156,575674
35107,12,36,3,45,40,136
6572,3254,55032,1769,1171,18496,79722
23083,73,1901,60,92,1084,3210
40111,407,6552,118,134,3869,11080
2183,143,3014,75,106,1469,4807
7245,38,336,20,77,320,791
12565,1933,72127,834,468,26852,102214
43593,0,10,0,7,11,28
15843,1748,9543,786,564,4960,17601
11083,290,8058,159,206,2695,11408
39635,15,31,6,95,80,227
37534,10,410,3,13,66,502
21539,12,129,10,90,134,375
33988,19684,246931,7823,9263,88039,371740
24819,15,67,4,49,147,282
8961,99,1849,63,211,966,3188
20613,41,4139,22,69,536,4807
3581,252,2416,141,191,1059,4059
38653,314,10184,151,231,3603,14483
19137,25,1797,14,31,244,2111
48450,1134,1848,350,218,729,4279
2768,195,15668,89,98,3016,19066
27405,19,312,10,47,116,504
6447,41,160,16,45,368,630
5648,81,448,40,89,591,1249
43271,0,9,1,9,10,29
11447,35,1169,12,58,488,1762
41450,2,102,1,10,24,139
9965,17,123,4,43,124,311
5260,26,128,7,42,142,345
11185,1439,4921,597,593,2943,10493
889,39662,511774,27764,17976,250153,847329
2603,649,8080,640,874,5606,15849
38004,1028,6106,451,1203,7536,16324
50653,0,0,1,0,26266,26267
9535,27,317,23,59,540,966
41224,821,1177,299,261,4092,6650
1520,2769,12455,1738,1293,16471,34726
37185,236,1235,76,100,823,2470
5440,159,664,101,138,1205,2267
2568,28,324,28,94,272,746
24811,11,132,4,32,77,256
39842,402,656,143,121,405,1727
3568,163,1155,111,186,1462,3077
35963,23,78,12,79,112,304
561,1218,8874,1113,1229,10063,22497
35531,7,91,2,18,27,145
39562,8,116,4,25,59,212
10280,355,3754,184,169,1158,5620
14519,13,198,17,36,230,494
4342,477,2977,268,222,2039,5983
50290,14,127,8,9,140,298
43446,2,66,3,7,15,93
40658,4457,7,880,397,1831,7572
35628,21,201,10,51,152,435
7655,1867,44199,852,643,9080,56641
11579,21,702,6,30,146,905
40823,74,279,22,59,224,658
42174,176,443,60,66,1914,2659
38712,7,592,4,36,68,707
34000,10,60,6,40,120,236
38055,534,4993,222,261,7815,13825
28581,12,61,6,66,73,218
9862,33,238,19,48,229,567
6587,177,3425,105,123,2278,6108
5551,40,261,36,61,191,589
46310,1,4,0,11,19,35
35994,46339,295220,21775,43585,136013,542932
3870,47,243,40,117,398,845
32191,260,5593,132,143,2764,8892
3155,20,337,9,45,220,631
2345,91,1093,52,100,827,2163
42785,1,65,2,5,13,86
878,1584,12337,1420,1715,14716,31772
36906,6792,38043,3058,8087,33102,89082
8038,646,30416,366,214,8942,40584
2169,268,4206,221,434,2872,8001
8840,82,2579,57,63,1017,3798
18311,9,71,3,40,75,198
38461,56,199,31,33,629,948
19051,988,10135,523,406,3200,15252
1634,481,6993,300,352,1944,10070
33741,131,2524,68,65,2743,5531
48,7289,96561,8750,12751,43990,169341
31598,502,10448,186,343,9133,20612
43775,3,104,3,7,20,137
25635,208,1994,213,133,2293,4841
36214,2541,45148,775,385,36430,85279
3205,224,963,152,220,1810,3369
11013,21812,286429,15200,18336,117065,458842
6087,65,448,59,122,431,1125
2413,799,7558,409,349,2974,12089
43756,12451,32307,3003,3711,31483,82955
8696,11,270,4,29,75,389
37374,1460,4138,688,3971,7890,18147
38690,47,103,23,54,262,489
12165,22,200,3,48,210,483
35610,19,229,1,29,125,403
51009,0,0,0,0,13819,13819
1666,85,523,90,153,771,1622
34696,6,74,2,35,64,181
4717,165,907,94,111,696,1973
42457,7,27,2,22,54,112
43543,0,7,1,7,9,24
32245,11699,63486,6751,9899,34593,126428
35294,7,237,4,16,41,305
11793,141,5262,149,94,2746,8392
40349,2,150,5,11,37,205
3982,95,702,66,97,495,1455
2582,1695,5547,1206,692,11605,20745
39629,70,101,14,48,294,527
492,295,12697,174,124,3327,16617
9712,3380,35129,3076,3350,16119,61054
5305,197,6874,145,96,2565,9877
14073,1475,10032,1166,2274,8943,23890
44194,998,1261,333,232,955,3779
30745,1368,37306,554,451,14688,54367
34712,14005,109662,7069,10251,59440,200427
2046,37,494,29,59,558,1177
35672,1069,9286,393,349,8679,19776
43620,1,11,0,5,13,30
35092,5,20,3,31,28,87
36444,148,765,78,132,3874,4997
8967,19,122,12,46,239,438
1864,497,4480,322,369,4394,10062
4654,45270,435466,33406,31832,179072,725046
222,859,9897,816,1005,6624,19201
25015,3077,97364,1384,852,42163,144840
5835,4937,28255,3956,5017,21302,63467
3186,77,2110,41,76,1182,3486
46299,1,8,0,11,22,42
32829,1939,9903,1049,1714,5818,20423
4765,414,13349,349,272,7639,22023
40702,3,129,4,5,21,162
293,728,12163,691,1210,5736,20528
3908,160,1167,105,153,750,2335
42843,4,67,2,8,17,98
39455,3,40,3,38,30,114
45571,3,46,2,6,42,99
49094,4,128,3,10,18,163
7748,2528,32048,951,754,12517,48798
20603,14,99,6,47,77,243
44204,0,0,0,0,50946,50946
30468,9,154,4,40,117,324
43385,1,40,1,7,11,60
13255,17,598,8,34,186,843
20655,432,24197,247,267,5817,30960
35500,0,1,0,0,78874,78875
35364,10,55,5,38,45,153
28089,10,68,8,61,77,224
29181,5,167,3,32,28,235
11685,41,889,22,38,326,1316
39376,5,32,5,28,47,117
38085,1398,25070,680,254,36760,64162
43819,0,10,2,5,10,27
48078,0,5,0,9,12,26
10017,397,32028,270,244,4218,37157
30075,10,311,1,31,52,405
2451,1249,7095,923,652,8880,18799
37958,3274,24863,1376,1243,13144,43900
35167,4,19,4,36,33,96
36762,405,427,140,192,1055,2219
30978,6,31,2,42,42,123
16982,1551,25851,1097,1245,11562,41306
18375,16,593,11,30,120,770
2369,3565,24825,3468,4179,22145,58182
39893,708,1441,153,1121,1626,5049
5141,880,7770,717,829,8882,19078
35091,5,22,2,37,47,113
38998,40,164,21,49,563,837
29249,11,121,6,35,95,268
8713,39,1662,12,53,594,2360
32872,1552,11619,602,495,2854,17122
10824,79,1917,75,97,1315,3483
40685,13229,34004,3743,5124,31018,87118
9911,385,11645,213,396,4437,17076
35162,5,21,1,43,34,104
44074,22459,60008,4398,2158,94418,183441
1980,380,7639,236,204,6246,14705
22347,791,3976,374,296,1941,7378
41945,2,106,4,6,29,147
2872,165,1275,112,138,965,2655
32059,33,295,19,40,209,596
47426,4,83,5,24,50,166
9316,45,215,24,74,215,573
16780,13,68,3,41,81,206
34943,47,402,14,32,533,1028
36791,162,874,51,59,568,1714
32415,377,5634,141,158,3938,10248
45529,1,12,1,15,16,45
8182,29,190,34,108,208,569
48549,0,0,0,0,79488,79488
39135,2,32,2,27,29,92
13231,377,9031,309,841,2157,12715
12391,18,93,15,68,152,346
3661,46,751,22,41,561,1421
5719,1038,22476,391,477,3973,28355
43568,72,4168,30,43,677,4990
31264,9,213,4,30,63,319
48094,1,6,0,10,19,36
42293,0,0,0,0,190,190
37988,574,5026,217,410,2594,8821
48029,0,6,0,10,13,29
32400,95,1128,82,199,518,2022
30128,375,3832,223,220,1347,5997
2933,142,493,123,151,1126,2035
15077,66,3212,36,66,1047,4427
25055,502,3465,308,248,1950,6473
22789,27289,371752,16252,9269,159707,584269
23,209,1470,162,312,1908,4061
9312,510,3008,284,241,1518,5561
37689,6,70,2,17,24,119
1398,298,6856,244,173,4666,12237
1350,603,6174,264,218,8027,15286
41589,0,0,0,0,13733,13733
32738,12,64,5,41,57,179
25437,463,20147,238,229,4088,25165
32835,16,101,3,65,118,303
39259,3,186,0,15,49,253
19391,3309,31834,2993,2704,9461,50301
48680,2417,2609,471,4500,9726,19723
38794,5,126,1,8,29,169
478,3212,38791,2629,3590,22966,71188
1314,102,699,83,135,950,1969
731,854,50402,418,332,12933,64939
46925,0,0,0,0,162,162
3112,243,1204,142,269,1825,3683
6704,576,8616,378,340,4161,14071
43383,0,8,0,15,15,38
28489,13,65,5,51,123,257
39480,687,7359,323,183,5823,14375
18617,2053,63716,690,659,24657,91775
43504,0,3,0,10,11,24
4918,1438,44353,775,423,17165,64154
40379,619,3806,281,303,6691,11700
167,3677,44538,3756,3495,32197,87663
33695,8,175,3,21,49,256
42431,7,196,3,7,21,234
7261,304,3313,247,183,962,5009
16241,1248,25333,642,627,6658,34508
43651,0,29,2,7,10,48
37545,13,301,2,28,87,431
6383,383,997,232,447,1218,3277
1421,104,3616,84,83,2008,5895
30218,118,1655,76,115,1643,3607
4761,53,642,45,54,981,1775
3290,59,204,45,103,485,896
17791,97,4285,37,51,844,5314
2698,127,1751,70,72,2052,4072
28567,7,45,2,60,49,163
47618,25,160,10,32,144,371
35913,12,42,4,36,67,161
4818,114,582,80,91,572,1439
14735,388,28672,196,227,4060,33543
38869,4,85,11,50,66,216
6016,425,6926,249,267,4243,12110
11511,22,1079,9,40,206,1356
39292,27133,104690,8988,14866,64335,220012
41487,65492,312699,4331,2405,110395,495322
5814,13,1040,7,52,123,1235
34252,73,1886,23,61,668,2711
168,2717,46317,2742,3023,22156,76955
40621,1,16,3,28,130,178
36574,10,144,2,33,83,272
38066,5,160,3,43,66,277
40128,9746,53450,4029,7446,33845,108516
32410,491,4245,230,296,5274,10536
36074,7,263,4,18,41,333
3301,182,1109,130,121,906,2448
34644,306,4716,141,123,4113,9399
11545,26,140,18,71,287,542
13171,821,20808,319,107,11454,33509
40172,10,630,4,13,72,729
19981,14,85,12,97,122,330
4820,95,697,45,100,496,1433
10869,116,1672,106,225,609,2728
6443,787,8988,420,478,6333,17006
833,580,6003,509,631,4489,12212
38048,8,70,0,33,65,176
747,389,20676,182,309,2941,24497
18491,9,192,7,75,86,369
18245,9500,120818,5133,5766,80087,221304
32150,13,379,6,52,89,539
43667,0,10,1,5,10,26
48118,1,4,0,12,20,37
13561,672,12519,611,503,10335,24640
51088,61,0,29,14,92,196
30556,20,55,5,53,62,195
3294,57,229,46,97,389,818
18029,14,212,7,44,120,397
48338,1,13,1,15,23,53
7066,228,5705,156,134,2589,8812
10648,22,156,13,45,286,522
19925,31,421,21,57,205,735
35243,9,28,2,35,78,152
50503,30,189,4,15,146,384
48323,1,16,3,19,23,62
39741,5935,230908,2056,641,74137,313677
21491,21,119,8,71,110,329
12955,354,2549,220,172,1056,4351
36774,14,463,6,41,180,704
23189,34,637,41,116,289,1117
30912,100,1830,41,45,1075,3091
27721,101,194,69,85,464,913
33337,8179,71798,5466,7086,50719,143248
42717,73,108,69,129,432,811
11499,23832,364931,13646,14988,125408,542805
42800,5,103,1,15,40,164
31984,32,366,32,58,483,971
10421,491,3359,277,208,1480,5815
9999,677,41032,424,417,7874,50424
31107,20,598,8,36,182,844
25877,701,2825,331,272,1724,5853
7169,24,602,14,40,388,1068
35018,55,268,46,55,926,1350
49143,1,12,0,17,27,57
43632,0,15,1,3,10,29
39792,34144,118814,16653,14003,97294,280908
3201,32,344,33,108,242,759
17315,12,84,4,63,82,245
17295,33,253,18,48,293,645
26215,7,28,2,46,46,129
9724,532,45024,325,214,7220,53315
5811,14,903,6,45,94,1062
48709,3,59,3,5,19,89
9939,267,1213,147,143,788,2558
30902,1031,36697,461,258,11250,49697
1859,283,10823,149,178,3083,14516
46375,1,4,0,11,18,34
18305,21,174,13,76,197,481
1418,178,6000,120,115,2995,9408
29793,7,202,6,45,73,333
22815,404,2001,197,197,970,3769
42429,0,0,0,1,46873,46874
39115,72,1169,39,60,684,2024
39258,6,337,4,19,53,419
33165,593,3497,278,266,1422,6056
7270,290,6460,192,212,3868,11022
41033,2,164,0,5,23,194
15649,792,7131,598,676,3733,12930
18745,662,27162,376,256,11581,40037
31380,4051,54980,1386,593,14490,75500
49637,1402,2942,238,228,3122,7932
48345,1,9,3,22,19,54
8361,60,2502,38,109,633,3342
40799,14,417,4,30,120,585
853,45253,750849,31885,29882,128389,986258
9070,30,119,17,76,106,348
10122,131,7653,87,57,1840,9768
37291,396,411,128,178,3461,4574
43996,1,25,0,18,23,67
4099,21,774,8,44,209,1056
32293,9,360,2,19,49,439
33349,15,91,5,43,77,231
1824,889,20965,493,269,20709,43325
36424,290,1815,149,153,3648,6055
49478,3,80,2,9,60,154
30770,679,1828,288,251,1432,4478
43657,0,16,1,4,7,28
38827,57,17,14,46,81,215
26183,604,5860,281,184,5468,12397
1995,271,4100,130,188,2589,7278
37588,3,117,0,12,36,168
34840,10,425,6,23,102,566
41453,5,122,8,7,24,166
4981,8756,58184,8799,8696,63018,147453
7698,19,192,13,37,231,492
22435,112,1800,69,85,1349,3415
830,1088,12242,457,428,3134,17349
44406,3303,2459,335,244,11081,17422
1786,113,1076,63,93,899,2244
33661,96,1411,55,145,604,2311
4795,153,14817,138,183,2330,17621
3335,299,862,260,231,3428,5080
50518,1,43,2,3,17,66
48542,0,0,0,0,6892,6892
11043,27,305,14,37,334,717
40859,1,83,2,9,17,112
39839,23,30,11,66,102,232
2948,65,2930,60,83,1265,4403
7769,12540,158691,7297,8472,70156,257156
49059,46,853,23,27,740,1689
3635,126,1739,75,150,708,2798
24981,11,112,13,91,81,308
50100,2,19,0,2,3,26
38142,5,334,4,13,55,411
15845,636,3883,339,316,1686,6860
42456,9,21,6,27,107,170
5397,61,3669,31,117,350,4228
30686,81,2840,75,119,1096,4211
5474,25,346,33,109,270,783
31757,7169,288391,2119,911,81638,380228
38133,3,89,3,44,32,171
43447,0,8,0,7,15,30
38362,2,111,2,10,24,149
299,683,22407,1090,900,6614,31694
30641,614,13246,379,243,8391,22873
37972,11404,81861,4439,4785,62318,164807
31269,8,244,4,36,70,362
10863,4553,332107,1653,808,51923,391044
36753,41,746,12,57,558,1414
24791,6,65,6,54,62,193
23001,19,117,9,85,92,322
4314,20,269,14,52,198,553
48631,482,3248,59,87,644,4520
17221,44,301,14,56,494,909
892,397,43703,305,263,5441,50109
5299,10,612,6,26,154,808
33431,5,27,3,16,27,78
12683,19,1679,6,31,153,1888
46587,224,8574,65,57,1707,10627
4015,816,44901,722,422,11618,58479
50657,76,0,6,17,71,170
34164,9,47,5,42,55,158
19049,14,65,3,55,95,232
1984,43,2223,19,65,424,2774
33319,7,27,3,38,60,135
1725,218,2569,122,192,2014,5115
6798,38,523,31,90,237,919
10578,8268,100419,6574,11365,39570,166196
10406,46,2025,22,66,546,2705
7276,437,3289,242,211,1516,5695
50030,8,592,1,7,55,663
16614,134,3927,104,89,1836,6090
2078,54,1181,53,71,725,2084
13365,12,141,3,67,105,328
1596,263,2845,192,367,2628,6295
41185,3,138,1,10,25,177
38475,0,0,0,0,36328,36328
36493,42,712,21,38,439,1252
15865,25,151,20,91,256,543
50400,0,0,0,0,275,275
37148,248,1601,87,130,2214,4280
40406,2,32,4,21,54,113
33864,9,92,3,35,55,194
2564,689,9431,748,1200,5151,17219
33581,3076,112452,1071,607,34796,152002
4653,347,1911,203,201,1348,4010
4618,1862,24624,1721,1993,14577,44777
35512,1870,4948,740,486,3391,11435
7575,77,212,69,102,587,1047
51116,0,0,0,0,540,540
966,26837,7,15050,15770,12100,69764
36326,8,25,3,28,36,100
11523,356,1798,171,158,953,3436
1704,509,3429,376,496,4762,9572
26163,14,81,10,74,94,273
18619,685,33066,309,200,7305,41565
48615,293,1224,160,147,1689,3513
40569,51,2995,13,24,324,3407
39609,2862,10078,1003,2034,16447,32424
23183,21,102,24,106,120,373
147,4192,79886,3497,4711,40253,132539
3033,264,18808,194,173,3742,23181
2735,35,131,14,73,198,451
49819,0,0,0,0,942,942
11583,158,7041,114,147,1953,9413
43412,0,8,1,5,11,25
152,1195,14127,1509,1551,8997,27379
36871,1142,12421,691,1546,6222,22022
37088,940,3031,377,260,1373,5981
41542,6,186,3,13,36,244
3057,327,11723,208,369,5046,17673
50607,0,0,0,0,1597,1597
2365,65,800,34,52,795,1746
2742,36,109,17,80,217,459
35444,60,48,21,131,287,547
32,11321,640707,3237,1957,101360,758582
2696,95,1482,62,63,1268,2970
36799,14,614,6,21,126,781
3363,1658,5674,1526,2085,13335,24278
43533,0,6,1,6,11,24
29545,10,73,2,41,51,177
7504,11,413,4,34,135,597
6251,78,1164,55,56,909,2262
33736,0,0,0,0,1529,1529
32749,7,404,8,21,52,492
374,199,2718,220,287,1746,5170
36890,98,250,45,99,1353,1845
9441,959,30943,643,748,4496,37789
23967,9,66,4,50,75,204
24211,4016,71965,2027,4208,18592,100808
48305,8,347,5,22,123,505
37369,34,147,13,61,251,506
32764,9,293,5,17,65,389
30916,36,474,7,28,335,880
29353,9,215,2,26,43,295
28571,7,31,3,42,35,118
1166,136,2175,110,103,1641,4165
40783,3323,14191,1025,5313,9600,33452
35264,15,365,5,21,127,533
37955,26,883,12,32,374,1327
43638,0,25,0,5,7,37
49184,63,27,14,98,263,465
243,2985,80837,2532,5503,18915,110772
15771,1687,50639,738,490,30310,83864
4178,73,700,50,91,359,1273
13125,48419,280046,33398,30399,309096,701358
23673,16557,302616,7730,15054,70658,412615
12657,25,220,9,57,243,554
39972,201,4424,76,89,3232,8022
22593,12,168,6,41,92,319
5663,99,348,49,100,450,1046
9919,71187,1312460,43402,48230,219815,1695094
33529,9,135,2,28,50,224
23375,103,229,86,227,994,1639
37664,11,115,9,54,129,318
6266,57,631,36,47,818,1589
23987,606,16248,288,176,12516,29834
45866,1,6,0,11,17,35
4646,190,2899,114,133,1690,5026
2842,125,11312,113,128,2060,13738
31265,10,203,4,29,60,306
104,2270,32960,2613,3606,15753,57202
36111,4,89,0,8,16,117
38933,7,121,3,13,57,201
1012,38,1117,16,59,360,1590
38042,3,152,2,8,33,198
35971,96,677,50,331,324,1478
17379,56,862,36,53,718,1725
31851,312,3995,154,144,2967,7572
17020,148,2602,111,100,1962,4923
18469,21,50,7,66,100,244
2103,79,1422,34,59,1388,2982
13559,360,2371,260,204,1446,4641
1694,1075,7174,1121,1773,10268,21411
10997,28,109,11,59,147,354
37368,74,235,23,135,199,666
19681,31,123,42,99,234,529
3089,973,28752,546,449,20309,51029
50094,149,2573,42,36,1220,4020
50197,0,0,0,0,84131,84131
34113,12,36,3,39,56,146
19653,2020,23936,627,443,19697,46723
43648,1,11,1,7,8,28
8476,5823,60319,3768,4231,38339,112480
28665,11,279,7,35,97,429
30080,31,286,8,29,245,599
1208,81,1840,48,87,1538,3594
37535,11,177,2,21,72,283
5870,26,883,11,53,136,1109
8233,54,174,26,50,635,939
34754,245,320,204,217,1270,2256
3754,113,1131,97,178,815,2334
29481,10,240,5,35,62,352
4218,9,207,3,36,111,366
45755,1,7,0,10,19,37
2439,183,1250,110,116,791,2450
44003,2,25,0,20,29,76
1198,789,9599,676,929,6521,18514
2553,236,2038,219,246,3511,6250
35789,4376,30679,1342,1038,13001,50436
9690,363,13894,204,206,3909,18576
50159,0,0,0,0,20132,20132
8065,41,163,26,73,276,579
37058,63,112,21,35,332,563
39426,2,18,3,29,29,81
33926,24814,197712,8354,11188,83700,325768
10101,542,1994,211,209,1120,4076
2665,72,5619,75,118,608,6492
29385,14,61,4,59,72,210
40202,6,195,2,17,42,262
8842,23,274,11,39,297,644
30296,33683,621544,11233,17950,118483,802893
31494,29,474,23,65,454,1045
26139,9,34,2,45,55,145
2142,2298,30942,2738,5266,7515,48759
30074,6,252,3,32,46,339
16648,58,1416,52,91,814,2431
4379,177,952,88,119,654,1990
22177,15,883,13,40,208,1159
2488,323,10327,217,157,7540,18564
46084,23,137,29,27,293,509
8311,2834,33255,2346,1742,18594,58771
32892,33,88,10,83,146,360
5891,79,731,61,111,660,1642
36593,1797,4193,845,810,5776,13421
38579,39,30,14,43,327,453
33341,1145,5954,735,2213,5376,15423
9163,41,470,26,99,413,1049
6149,1289,1,599,783,1194,3866
24373,15,202,10,66,250,543
2066,61,707,55,50,754,1627
41499,5,91,3,5,25,129
5826,32,1406,13,61,210,1722
17247,15219,193399,8055,10771,68489,295933
11791,20,246,5,60,132,463
9546,18,68,4,57,183,330
7953,29,1488,24,60,461,2062
34910,9,329,5,18,61,422
1042,158,8005,69,178,1644,10054
2486,304,2177,299,222,3414,6416
49878,5,257,0,4,21,287
30571,26,201,13,44,234,518
34114,10,30,1,24,40,105
999,145,3610,159,116,1960,5990
3738,53,4146,39,113,327,4678
36632,8819,51732,2885,15182,34935,113553
8647,16,677,5,27,111,836
34925,14,59,5,35,88,201
35650,129,193,48,89,412,871
2699,117,844,94,165,1065,2285
39011,161,2432,79,108,1306,4086
42809,6,136,3,9,25,179
17983,12,202,9,46,115,384
1157,1208,17975,1945,3823,9377,34328
35105,9,25,3,33,56,126
33532,956,3408,496,1793,5445,12098
35783,7,79,1,19,32,138
8653,471,2545,252,204,1435,4907
29445,11,62,2,47,62,184
20509,4437,100324,2361,2309,34674,144105
34631,14,219,9,51,121,414
33604,23,38,6,52,115,234
10067,1670,198089,1105,537,26241,227642
16702,20,587,23,77,255,962
25605,9,49,4,48,63,173
1581,1168,17790,901,1368,8855,30082
20205,9,77,7,60,80,233
30694,101922,482695,24807,32383,51253,693060
10447,5721,54429,4085,5654,29969,99858
40353,3,158,3,10,30,204
29870,8,192,5,39,87,331
36613,37,0,18,43,51,149
10368,45,188,28,80,183,524
32767,7,263,4,23,40,337
41195,111,3499,22,32,490,4154
7882,105,2185,83,126,1773,4272
48020,0,4,0,11,12,27
2766,155,1576,188,360,1263,3542
2912,57,1404,77,195,341,2074
16870,6156,453622,1095,844,32404,494121
45961,360,672,96,76,2276,3480
39627,2,7,3,28,21,61
37395,658,729,313,893,3031,5624
45728,1,4,0,10,20,35
33272,20,213,6,30,76,345
6633,2240,27871,1360,1945,16003,49419
39628,9,34,11,50,88,192
6899,78,1139,47,105,656,2025
4645,160,701,74,116,689,1740
37723,10,175,2,37,57,281
2579,84,3638,69,198,552,4541
21521,1424,18978,610,769,3779,25560
17879,914,17155,747,520,9999,29335
15005,2783,19176,1388,1355,16500,41202
16774,2851,63781,1773,2800,22988,94193
34369,16,66,8,64,82,236
49532,97,67,36,15,2327,2542
8492,15,76,7,52,82,232
34741,92,166,50,173,450,931
49551,0,0,0,0,164,164
39046,50,173,34,56,509,822
4021,1601,17994,1432,2105,11764,34896
2743,139,5047,121,153,2179,7639
5374,30,121,9,63,163,386
41215,55,332,22,46,195,650
41528,232,1704,55,87,485,2563
43495,0,9,2,5,10,26
35136,99,132,80,40,10328,10679
30240,35217,640429,17149,33652,136362,862809
18753,2667,206746,987,531,25392,236323
1939,79,1322,79,149,1029,2658
42797,32,371,16,35,217,671
39622,512,2453,228,905,1574,5672
31181,19476,261049,8847,4453,129827,423652
1506,608,43645,254,282,4329,49118
19613,561,21224,226,232,7848,30091
42179,5,15,7,52,72,151
39703,4,258,4,10,57,333
41630,5,145,1,4,16,171
40812,6,138,2,10,34,190
31588,10103,51379,5293,10857,22605,100237
42949,152,619,35,62,608,1476
2122,69,3202,65,105,868,4309
1770,151,1152,91,144,840,2378
36530,12,121,8,50,54,245
490,3395,22391,4458,4416,22710,57370
41169,6789,16413,1173,1128,22947,48450
1346,516,7457,283,270,6323,14849
4495,60,372,39,78,278,827
15813,447,7389,222,140,7923,16121
1106,187,4738,99,138,3934,9096
33358,24,164,10,49,235,482
31977,51,1457,19,39,651,2217
48325,1,9,1,11,21,43
37944,3,54,4,38,34,133
30885,6246,186002,2638,709,36168,231763
42275,2,70,3,9,28,112
4340,147,691,77,116,597,1628
15735,334,7035,177,243,4014,11803
34826,16,96,8,42,153,315
9756,45141,799992,28111,24323,225440,1123007
964,221,2994,201,311,2094,5821
33818,295,10080,151,132,4282,14940
50695,0,0,0,0,2051,2051
3630,41,222,34,103,329,729
31008,8,34,2,43,38,125
24087,53,238,32,64,434,821
411,3416,37950,3725,3784,22012,70887
31113,107,1502,65,112,1086,2872
16490,17,96,7,58,114,292
36979,31,112,22,65,450,680
24861,6,319,3,49,71,448
43426,174,1463,94,98,588,2417
41911,20693,23810,6034,9074,44530,104141
31499,3825,12413,1451,2799,17774,38262
16099,4248,55503,3692,5782,16097,85322
41383,63,68,86,128,186,531
45763,1,4,0,10,19,34
1332,150,1887,99,138,846,3120
47391,7064,19154,1481,5526,11745,44970
25431,540,4097,199,261,4818,9915
24415,29807,526026,10543,6337,70862,643575
41769,6,359,2,8,25,400
40182,3,55,4,46,61,169
22563,11,178,3,43,96,331
31227,591,5151,330,307,3464,9843
34720,10,353,3,24,45,435
68,11375,153217,12414,11909,62063,250978
30813,1077,11107,320,324,6739,19567
9213,757,21049,335,217,11246,33604
37548,13,415,1,14,117,560
6581,173,7981,122,116,3802,12194
3673,1831,12703,1555,1512,14615,32216
7367,620,36610,463,365,9052,47110
13145,981,17179,609,719,3105,22593
19447,95,895,83,118,1107,2298
19219,13,736,5,27,134,915
41164,27,1915,7,19,174,2142
12531,14017,180991,8843,6097,124851,334799
36664,102,363,34,82,1026,1607
38508,9,175,2,19,52,257
6496,88,1520,76,71,1772,3527
12133,19,638,17,24,392,1090
34623,112,1446,64,74,1345,3041
33946,35,36,14,115,143,343
34055,6713,103137,2122,6029,31729,149730
41078,81,174,19,64,187,525
40504,2522,9088,553,472,5234,17869
34940,296,615,104,159,1327,2501
6847,13,531,1,39,89,673
290,1839,21180,1236,1042,21495,46792
39242,2,155,1,9,36,203
37496,3078,13419,1448,3516,12256,33717
37924,2449,26609,933,644,10126,40761
23729,7,27,3,40,44,121
43233,0,11,2,8,10,31
42321,681,1888,217,1402,2683,6871
24763,95,1559,64,50,1143,2911
23005,13,102,9,78,132,334
37303,545,8587,340,148,11802,21422
10920,417,7092,289,283,4964,13045
10834,753,22571,547,420,9873,34164
18195,5603,90326,3542,3045,48258,150774
7729,23,260,5,54,158,500
43313,3,12,0,11,21,47
50315,0,0,0,0,15401,15401
38560,6,62,6,44,65,183
32806,102,1653,60,117,1118,3050
258,501,7753,406,531,6963,16154
5291,289,5902,144,121,3501,9957
36580,10,150,4,34,56,254
39374,4,37,8,37,74,160
30602,12,68,3,47,81,211
37181,516,1225,198,181,2070,4190
42783,34,885,27,17,334,1297
35058,11,20,0,41,38,110
38940,10318,50383,4616,11443,27394,104154
6604,337,1025,332,359,2359,4412
50748,8,96,3,4,36,147
39058,1079,3880,373,260,1551,7143
568,1505,17151,1735,1591,12058,34040
12699,149,2348,98,89,1646,4330
3710,564,4082,594,695,4816,10751
18481,56,316,28,96,283,779
36816,467,27247,207,215,7198,35334
37576,6589,22242,2102,9070,19217,59220
5118,2986,63153,2879,2999,22719,94736
35025,50,111,18,109,342,630
26095,11,35,4,42,58,150
1527,239,23786,193,201,3198,27617
3665,811,8041,637,292,7999,17780
20667,63,941,50,86,824,1964
32760,7,287,2,18,62,376
36927,340,23049,210,179,6747,30525
998,1214,12326,1179,1288,10749,26756
41547,15,311,8,37,102,473
49073,0,0,0,0,2017,2017
35560,9,121,1,14,28,173
39890,4,267,0,16,41,328
39337,3015,22075,957,1973,13308,41328
4208,94,814,80,161,667,1816
17977,13,169,7,37,121,347
8524,28,167,20,59,306,580
39482,139,920,51,74,1352,2536
24809,11,90,5,52,70,228
32642,10,295,0,34,67,406
1462,3756,45235,1715,676,47588,98970
2058,40,773,25,53,460,1351
26285,13,101,5,43,94,256
38765,7,147,2,11,34,201
40904,39125,114721,6618,9833,77535,247832
34930,16,640,7,30,95,788
40844,14,35,3,22,39,113
20001,22,88,10,87,145,352
18301,7,52,3,38,58,158
9826,28,364,8,45,333,778
13281,29,1991,15,30,333,2398
38411,43,390,15,35,484,967
37778,269,3828,69,141,1095,5402
33755,125,139,44,72,1224,1604
50905,0,0,0,0,898,898
6582,481,3992,300,285,2299,7357
42332,11,27,6,42,71,157
29766,13,461,8,26,86,594
23013,22,115,14,91,159,401
38097,36,0,21,35,71,163
19871,240,380,161,346,1098,2225
1342,233,5966,101,131,2994,9425
45780,2,7,1,8,18,36
38568,5,37,2,36,57,137
4469,164,6353,167,213,3335,10232
8681,9,373,4,40,73,499
417,1698,28566,1815,3596,10347,46022
21163,26,188,3,30,153,400
3228,5944,69527,5777,3057,37751,122056
8550,34,554,30,59,491,1168
19727,103,3103,73,94,1026,4399
25063,17,93,8,70,86,274
49460,0,0,0,0,736,736
34005,20,106,9,53,93,281
24021,578,2427,270,205,1467,4947
1219,1138,9388,1336,1693,6274,19829
1664,167,1307,118,227,1352,3171
40478,7,77,8,32,77,201
29998,273,6732,147,146,2795,10093
14039,31,93,25,43,638,830
41027,5,42,5,25,56,133
253,1507,15433,2113,1998,10500,31551
30355,2116,22207,1178,2091,12762,40354
46279,1,6,0,11,20,38
35051,8,23,2,37,39,109
6094,140,1588,101,148,2188,4165
22575,11,198,5,61,115,390
49794,21,17,11,16,140,205
5310,524,19987,266,241,7538,28556
3074,171,990,105,148,913,2327
26327,12,44,5,45,91,197
34205,56,0,21,84,99,260
31882,7,111,2,38,37,195
42768,1,69,1,9,17,97
41691,139,1526,75,85,362,2187
35984,203,3186,98,112,3933,7532
6975,99,487,81,90,1932,2689
37362,428,8196,345,331,5733,15033
5217,72,905,56,129,528,1690
2945,391,2899,236,237,1304,5067
32521,30,869,15,48,333,1295
3305,198,1238,163,173,1353,3125
24123,43,1198,33,73,672,2019
4638,111,633,74,84,507,1409
2159,5036,46370,4300,2864,33674,92244
32745,9,368,2,20,54,453
39017,35167,183317,12772,22002,98795,352053
8481,962,16490,624,411,8846,27333
35224,501,4556,202,399,4196,9854
35773,395,5576,204,207,5960,12342
1535,161765,2738707,94694,101045,204892,3301103
35177,8,63,4,38,54,167
36378,10,111,2,22,37,182
11593,14,81,6,74,127,302
3559,2158,6814,1056,674,4499,15201
33849,10,65,3,36,46,160
38372,28,377,18,31,367,821
4158,29,2066,18,37,644,2794
34984,20074,119843,8301,9357,93406,250981
16518,3773,39379,2404,5045,15529,66130
25649,5053,83892,1879,1883,16357,109064
4440,27,182,11,62,290,572
31694,11,65,5,44,39,164
3010,359,7022,384,511,2130,10406
9744,279,6829,140,164,2599,10011
16023,384,5234,142,245,3768,9773
39007,35,36,8,91,668,838
40642,2,120,0,10,68,200
3853,44,1352,29,79,506,2010
2220,140,6412,77,140,1925,8694
648,347,3605,259,322,2980,7513
33136,7,39,5,61,37,149
36840,2464,18044,791,2608,12099,36006
22271,25,111,9,55,219,419
41664,2,71,3,8,14,98
34417,4,78,0,12,44,138
50639,3,36,1,2,5,47
15227,4259,79937,1659,686,70973,157514
10036,52,550,30,49,816,1497
9895,21,1120,13,51,261,1466
960,156,1932,137,170,1152,3547
2363,471,21476,719,758,4022,27446
48017,1,6,1,9,17,34
37294,364,783,98,113,924,2282
6734,46,783,45,60,795,1729
48832,0,0,0,0,3237,3237
1918,198,3950,163,191,2298,6800
799,237,2286,272,425,2727,5947
41161,2,23,3,22,26,76
31911,64,2436,53,86,877,3516
5883,367,721,336,451,2192,4067
35880,145,1738,87,149,2908,5027
32778,7,259,3,27,44,340
4266,77,361,38,100,979,1555
36293,7,165,2,19,37,230
8837,328,3660,174,165,1214,5541
48661,160896,40,20135,906,114739,296716
10681,1763,59694,866,589,24637,87549
27921,8,40,4,44,60,156
41039,7,127,2,8,24,168
8486,21,455,8,40,499,1023
12123,352,4719,282,643,1734,7730
15689,10256,391109,4035,2133,85774,493307
432,930,10636,552,431,8560,21109
8310,5470,35790,3077,2085,17608,64030
4967,31,402,31,42,386,892
5987,10,104,8,39,116,277
3300,185,815,94,111,735,1940
3787,90,2010,52,58,1335,3545
19081,31,2137,5,29,196,2398
6834,19,888,4,62,110,1083
6525,132,943,96,338,1292,2801
29853,151,2040,129,131,1940,4391
363,95,1607,95,80,1272,3149
40560,6,421,3,14,55,499
42887,4,77,1,8,20,110
38383,509,17681,176,163,4060,22589
25879,8745,154244,4145,3656,52130,222920
24439,55417,423752,31229,30809,211455,752662
32868,10,230,1,16,49,306
37207,276,2556,141,134,6541,9648
18447,42,144,21,59,336,602
3125,610,2364,486,393,4222,8075
13367,9385,123362,4360,7157,48395,192659
24603,12,179,4,68,110,373
3292,105,2634,121,86,721,3667
385,1641,11523,1912,2874,18760,36710
23085,17,74,6,42,120,259
10187,2255,20360,1643,3143,14895,42296
48332,1,13,2,27,26,69
1990,35,734,24,40,398,1231
1863,35,82,10,67,353,547
8853,49,141,46,84,337,657
38708,563,7287,324,297,2080,10551
30489,35,303,19,49,298,704
14467,32306,455485,19986,25886,154883,688546
22493,16,159,5,46,102,328
33760,80,161,23,51,438,753
16678,107,6517,107,138,1852,8721
50481,0,0,0,0,1969,1969
9976,19,631,10,34,168,862
38982,0,0,0,0,9234,9234
45207,213,9,79,186,825,1312
39787,3,89,0,11,22,125
2040,144,473,124,179,1432,2352
17743,711,14642,327,328,6749,22757
30210,9,252,2,35,66,364
18153,53741,623036,31526,30001,286189,1024493
7456,818,6528,395,356,2672,10769
36108,3527,16210,1473,3683,17085,41978
36581,9,51,2,27,39,128
47917,0,0,0,0,4985,4985
38299,6,42,9,48,80,185
32676,13,69,8,65,99,254
35658,726,21327,246,246,5068,27613
13501,9,81,9,52,83,234
39574,1022,10884,394,695,6490,19485
22961,2175,132892,808,463,19841,156179
48002,0,5,1,11,16,33
1502,297,2781,272,354,3029,6733
35081,92,884,39,74,1001,2090
33226,30,370,26,80,413,919
39710,24491,134698,8036,14317,82477,264019
42302,100,248,33,76,613,1070
42507,8,149,3,26,48,234
3021,165,609,133,184,1219,2310
41227,5,116,3,15,35,174
2301,58,1015,38,62,683,1856
30159,8,117,6,38,64,233
3259,83,515,55,90,859,1602
15657,10,90,7,48,84,239
39221,5441,19330,2671,9472,24944,61858
3313,66,815,48,157,560,1646
43399,0,10,2,5,15,32
3006,494,1875,475,585,940,4369
38014,8,47,10,43,296,404
41844,0,65,3,11,17,96
10541,35,100,18,65,351,569
37307,475,6686,298,134,9576,17169
22763,885,29928,481,181,10434,41909
20183,19,111,17,74,174,395
3458,61,168,37,97,190,553
1959,93,733,49,72,1216,2163
963,313,30441,263,169,4833,36019
37926,8791,55694,3419,8292,34437,110633
39911,3,103,1,19,20,146
15547,112,1957,86,170,602,2927
20353,63,188,29,52,660,992
8205,12,75,5,54,87,233
49426,23,283,18,26,817,1167
31540,3063,23605,2032,6528,14159,49387
48753,47153,43160,9313,15330,74138,189094
30431,7,325,2,31,48,413
37302,1934,9206,957,3080,12064,27241
37790,7,144,1,27,68,247
44583,0,0,0,0,2910,2910
1402,120,691,74,92,542,1519
41364,1792,13065,516,575,11780,27728
37447,14526,29701,7026,10925,44475,106653
30396,7,430,2,37,77,553
33723,42,129,16,59,363,609
12317,3474,35809,2267,4861,20634,67045
40034,657,613,314,261,1974,3819
5270,83,3501,58,113,1094,4849
18451,22,105,6,51,213,397
14817,320,6358,199,154,5568,12599
32997,428,4232,225,220,1454,6559
40435,2781,6735,564,383,7131,17594
7914,62,268,36,75,305,746
17493,33,232,16,58,466,805
42638,2,73,2,8,14,99
5082,220,1137,123,233,1402,3115
3747,481,3226,301,236,1936,6180
9423,13,475,4,21,232,745
5904,61,1229,30,65,720,2105
2239,78,422,48,90,517,1155
39699,304,1377,154,360,2400,4595
39701,49972,406448,14634,46223,83318,600595
1140,1209,43293,650,399,22123,67674
50324,10,476,5,3,54,548
38799,1171,9015,527,1335,16601,28649
42952,42,68,15,57,310,492
3895,112,699,57,100,481,1449
18781,134,1794,184,127,1089,3328
33281,37,2214,8,43,319,2621
43,9860,366236,4081,2177,157765,540119
1758,43,1138,36,59,625,1901
26117,17,174,9,64,180,444
38110,148,163,82,83,625,1101
43277,0,6,2,9,9,26
4000,131,1203,88,98,584,2104
25973,23,315,2,39,77,456
37438,1155,8972,656,1880,12835,25498
3674,272,9057,252,177,5830,15588
298,1362,45451,1900,2530,12462,63705
9520,42,175,36,107,341,701
22577,15,141,3,44,96,299
6468,56,378,40,144,408,1026
18179,15088,128646,9975,9044,44503,207256
40870,11207,33368,3023,5223,48722,101543
48016,1,6,0,11,18,36
14751,18930,59420,12379,15717,24512,130958
48107,1,5,0,11,18,35
2367,1414,10450,1404,2311,11013,26592
43342,0,16,1,7,9,33
4157,60,495,42,84,311,992
49831,0,0,0,0,17342,17342
36536,545,3464,235,366,4237,8847
4533,88,1214,39,50,1051,2442
34918,12,81,2,37,50,182
10812,11,200,8,47,137,403
6328,163,1344,92,141,930,2670
6760,10,125,4,49,95,283
39575,27327,111252,12121,13325,80350,244375
32867,34440,506093,14490,7701,111450,674174
34016,242,2214,169,249,4328,7202
5630,19751,296865,14359,10736,175789,517500
5278,62,149,23,86,461,781
39511,39,2455,19,25,275,2813
2454,185,5697,137,121,2403,8543
41530,3571,13423,877,678,28543,47092
26,13322,53420,10831,9041,126358,212972
1751,54,5308,55,77,1036,6530
50364,916,852,31,43,534,2376
1671,82,978,60,55,975,2150
45031,2,42,3,10,19,76
37320,1955,14665,609,1540,9195,27964
49985,9,25,4,5,43,86
34830,566,3994,302,277,12179,17318
41777,2,33,4,46,67,152
4023,52,878,43,113,416,1502
2359,161,3302,86,150,1809,5508
13833,488,16814,156,152,5182,22792
20931,4115,74159,1743,3044,22221,105282
49029,3,16,2,10,25,56
39128,2,20,1,30,31,84
719,764,26046,395,685,6592,34482
16806,11,87,5,45,92,240
28381,61,737,26,72,407,1303
35165,5,22,2,39,35,103
24133,16800,179597,6902,11176,61545,276020
30291,176,1495,173,166,2360,4370
6107,37,507,32,68,545,1189
49099,1,36,1,6,12,56
2647,16,340,13,44,137,550
39491,14066,85746,6452,5152,113318,224734
5658,266,2495,225,212,1762,4960
10172,963,34383,541,550,6185,42622
7861,116,1836,71,113,1310,3446
21021,14,66,12,50,184,326
31833,16,367,3,34,124,544
38503,4,108,1,10,21,144
4584,41,1319,34,149,229,1772
41917,273,414,70,120,1053,1930
33479,22,41,4,90,84,241
4714,314,3812,172,239,2266,6803
42297,14,13,8,9,131,175
43358,0,7,1,6,12,26
37178,710,920,285,435,2443,4793
50747,4,79,2,1,32,118
2911,170,2752,130,123,2100,5275
22035,13,110,5,62,84,274
240,6077,82710,5261,4890,64484,163422
2455,70,574,63,81,527,1315
8025,26,114,18,85,231,474
36049,7970,78157,3566,5076,47251,142020
2574,66,951,54,157,408,1636
34762,33,194,26,66,431,750
34628,8,133,2,35,69,247
1935,1092,5004,704,461,9861,17122
36117,8,228,3,13,39,291
517,789,44247,547,344,9727,55654
35577,9,46,4,44,50,153
37789,54,388,41,47,520,1050
3880,64,299,38,95,579,1075
1564,3748,141551,4004,6728,9902,165933
2281,236,5604,376,939,1462,8617
29651,11,191,3,38,56,299
39528,5,28,3,58,50,144
22215,134,1082,99,187,1389,2891
43226,0,5,1,11,13,30
47759,0,4,0,9,11,24
32322,7,138,1,30,26,202
39294,4,144,0,9,30,187
6203,3167,29987,2031,2453,29079,66717
26259,6,33,5,44,58,146
48021,0,3,0,9,15,27
30093,10,260,2,40,67,379
48022,1,5,0,11,18,35
2756,235,7733,157,195,4903,13223
8358,62,5886,44,101,722,6815
40024,368,10019,195,130,10268,20980
10813,15,654,19,74,279,1041
4356,267,1807,161,171,1000,3406
40054,0,0,0,0,16483,16483
145,13149,83600,11345,8836,79590,196520
49387,1,1,0,0,83460,83462
39108,11,155,9,25,148,348
9910,10,204,3,35,55,307
42646,2,64,3,6,16,91
46154,2,7,0,10,19,38
7551,38,218,34,86,285,661
37247,132,4847,50,87,903,6019
1470,5504,23122,3656,2333,31932,66547
36736,10,44,4,33,42,133
40181,94,2031,66,108,1115,3414
2983,127,4440,79,84,2226,6956
5583,80,6584,39,58,839,7600
43673,0,6,0,9,9,24
32122,683,21518,331,276,7012,29820
2648,68,3349,39,100,725,4281
4306,83,1210,55,70,1805,3223
541,502,13988,340,295,3902,19027
42650,2,107,1,13,21,144
19067,736,5060,521,920,2230,9467
39313,16,483,8,15,77,599
1485,921,9434,885,623,7945,19808
19511,771,50297,375,283,8097,59823
3065,74,758,48,52,779,1711
45614,4,128,1,9,34,176
46604,12363,1,609,3468,18085,34526
43803,0,5,0,9,12,26
2513,152,11882,120,125,1978,14257
10509,11,125,6,51,119,312
6008,549,4499,487,773,4140,10448
41266,2346,4900,947,1688,5635,15516
8516,8554,280746,5518,5726,44806,345350
49555,5,33,6,10,59,113
42820,10,194,3,8,43,258
10979,25,1361,13,68,391,1858
27377,9,54,6,82,67,218
24051,14,147,8,33,85,287
33898,34,1322,31,57,403,1847
33033,197,3508,107,151,2833,6796
38866,1432,10329,650,471,2655,15537
37606,3,136,0,12,39,190
3160,252,1809,174,191,1147,3573
32182,87328,1250085,34746,24677,265392,1662228
5505,461,4725,400,677,3359,9622
41426,94,109,30,102,942,1277
37403,37594,61954,13231,17967,37055,167801
7817,12219,260251,7833,14205,62116,356624
4808,113,686,90,174,983,2046
39514,31,254,28,30,455,798
6093,50,261,49,105,535,1000
10884,1873,19003,1153,1280,10450,33759
29547,12,92,5,43,106,258
40633,1,58,0,8,30,97
10270,22,157,7,46,273,505
1932,895,7784,885,739,4312,14615
42220,55,1303,8,45,303,1714
3549,2103,16324,2519,2933,16440,40319
9948,19,82,12,51,182,346
25609,7,82,7,67,73,236
40425,3,40,6,35,198,282
34051,10527,64178,5826,15145,36429,132105
22699,267,10902,175,224,3262,14830
30605,21,90,7,100,89,307
36160,707,2750,222,209,4172,8060
2437,267,2129,143,179,1106,3824
3519,70,612,56,133,367,1238
40465,124,3179,71,83,2171,5628
18573,15,79,5,55,102,256
40442,11,389,3,14,63,480
513,4677,338041,1862,799,62394,407773
38915,644,8354,182,282,6234,15696
9241,693,3824,479,750,2947,8693
26287,11,32,2,50,57,152
2134,319,2054,192,177,1286,4028
214,112,1332,74,105,638,2261
9491,68,1046,27,38,783,1962
4524,76,738,36,56,765,1671
28951,13,770,10,33,250,1076
1355,41,383,28,39,443,934
1053,154,1571,73,103,1259,3160
1051,1568,27847,962,991,19637,51005
28019,10,52,4,64,67,197
39160,3,25,5,28,35,96
34015,467,3171,228,231,1214,5311
31716,12596,103488,6117,13597,55022,190820
106,2803,28117,2379,3418,18133,54850
36125,320,14723,96,126,2595,17860
36521,210,694,101,176,1697,2878
43362,0,11,0,9,10,30
22485,21,245,3,47,134,450
8417,15,130,11,75,130,361
37466,5,128,0,14,25,172
49442,6,127,4,17,53,207
35309,25,49,10,57,87,228
20975,27,168,14,59,312,580
43319,0,5,0,6,14,25
11703,14732,190479,9320,17010,66680,298221
31762,287,2937,113,160,3968,7465
25731,11977,92365,5641,8525,58605,177113
30458,2560,183503,1055,874,31991,219983
29833,11,134,6,40,81,272
35191,674,15651,466,352,15856,32999
24967,718,6185,401,309,2061,9674
39697,9,183,6,32,104,334
37341,2187,29183,996,259,13441,46066
35517,37,77,19,121,190,444
33254,1052,10365,758,327,7208,19710
42435,9,204,3,7,25,248
8678,31,274,11,38,270,624
13667,3388,262660,988,698,21793,289527
35491,13,77,14,88,72,264
4789,5392,78898,4909,3984,62241,155424
37325,30,43,15,86,359,533
29603,43,82,15,92,184,416
8156,38,318,31,61,368,816
50461,0,0,1,1,19741,19743
9486,127,895,101,115,667,1905
3513,34,457,21,43,431,986
42682,1,65,1,11,14,92
20187,143,4355,87,73,2001,6659
8150,31,402,31,63,316,843
8919,27,363,14,46,262,712
35044,2934,7366,1162,2045,15265,28772
5947,337,18707,323,222,8048,27637
37842,63,777,72,73,884,1869
37452,11,446,3,24,58,542
5333,461,11105,311,256,4929,17062
50703,3,7,0,7,12,29
39121,3,23,1,29,30,86
5553,55,306,31,68,288,748
359,137,2670,101,130,2027,5065
1588,1700,12653,1425,1632,7873,25283
29897,7,233,5,40,72,357
6324,9535,153662,4688,6118,47867,221870
6843,20,709,7,56,150,942
2137,440,2446,222,236,1512,4856
3645,80,1021,47,84,344,1576
5348,174,9310,142,158,2370,12154
30778,2630,120671,1027,628,37430,162386
20705,15,225,6,47,132,425
857,12646,217025,11387,16290,67413,324761
8189,88,160,62,127,387,824
42482,94,62,29,122,631,938
36967,76,2294,60,62,1691,4183
44075,44,71,18,54,314,501
4928,79,265,59,109,776,1288
22053,38,316,36,57,627,1074
29433,12,51,6,44,68,181
47792,1234,2211,171,559,9455,13630
29876,1857,5005,963,1642,6760,16227
10603,13,82,3,36,165,299
10354,55,772,37,60,815,1739
26283,19,96,8,51,163,337
23341,991,17093,740,789,6032,25645
50142,12,0,3,30,31,76
36910,262,1497,53,123,756,2691
39088,5,139,3,15,41,203
36088,12,211,2,17,50,292
35287,20,60,8,53,88,229
43535,0,2,2,7,11,22
45783,2622,0,181,653,5482,8938
45574,65,1877,16,42,367,2367
8958,15,228,9,43,116,411
7982,22,103,6,52,420,603
41210,89,465,25,49,277,905
9522,36,158,14,91,181,480
527,37330,405092,33533,54474,23465,553894
1711,126,1061,102,177,1146,2612
49605,12003,36426,1529,1919,22287,74164
5908,53,553,70,139,319,1134
41194,554,7694,222,346,5713,14529
23515,14,170,7,51,119,361
34030,566,3857,274,287,1491,6475
2200,216,1473,186,169,2065,4109
30173,37,216,23,53,285,614
9907,364,13932,155,234,4092,18777
282,1059,5489,1121,1246,7090,16005
39690,11,162,4,15,70,262
50640,6,121,0,4,20,151
38897,578,6997,341,170,8886,16972
35982,191,5869,75,106,1846,8087
14935,72,2967,81,113,1212,4445
32151,216,3567,109,105,1967,5964
37468,9,226,4,47,67,353
40687,5,281,2,8,49,345
34410,52,186,34,106,428,806
1597,248,2202,342,509,1760,5061
2128,149,514,179,174,1322,2338
34756,7,51,10,56,96,220
40437,35,49,13,44,131,272
17721,24,67,12,45,290,438
17895,49439,557394,31627,38477,199872,876809
6672,68,274,72,133,453,1000
48324,1,9,1,12,18,41
2388,37,298,23,57,616,1031
33129,286,7903,160,150,5905,14404
37467,44,33,19,122,425,643
24641,2530,22807,1076,827,6296,33536
5593,1702,36670,1082,975,17779,58208
9906,28,137,16,76,201,458
35633,4,20,5,27,51,107
11521,31,381,20,76,242,750
17501,32,174,27,86,319,638
32981,6349,36756,3009,20730,29305,96149
2202,201,4980,128,129,3698,9136
40652,0,0,0,0,3008,3008
29489,11,52,4,56,48,171
21415,1589,23415,1050,593,7555,34202
2938,306,1795,265,234,2187,4787
33401,7,260,2,18,39,326
41132,259,3693,60,61,1902,5975
43672,0,5,0,7,11,23
4772,348,12531,289,232,6280,19680
2414,86,1968,62,98,1383,3597
32481,97,2809,81,104,1765,4856
20689,15443,156925,10285,12911,82708,278272
47952,0,7,0,9,13,29
2628,23,683,21,78,340,1145
32962,12326,73921,6971,16259,71139,180616
39353,1,41,6,32,61,141
29716,27,197,21,71,308,624
13183,666,11579,458,444,9811,22958
22851,10,73,2,61,91,237
17933,36,172,28,53,458,747
13247,81,1918,78,78,1343,3498
42280,3,75,3,7,28,116
3537,897,9020,400,369,2533,13219
43807,0,21,0,4,10,35
50306,0,0,0,0,42525,42525
3071,109,1555,72,93,1553,3382
30117,10,39,4,39,42,134
29701,7,326,6,36,89,464
1757,46,2557,30,67,577,3277
50678,0,0,0,0,2903,2903
1893,124,1221,128,243,881,2597
34844,20,153,12,57,216,458
37082,36,421,20,48,473,998
4298,61,430,37,71,638,1237
33286,12272,106577,4775,3898,44095,171617
8187,311,21253,112,61,3988,25725
51045,7,58,1,1,23,90
40776,55076,442747,8970,3929,103826,614548
10715,571,24618,294,174,7836,33493
30324,34,739,12,49,378,1212
31647,209,350,100,178,724,1561
925,173,2117,154,199,922,3565
1337,194,802,200,384,1999,3579
3538,285,2230,167,167,1096,3945
31948,14,78,10,92,89,283
6153,104,4371,87,121,1592,6275
36242,91,2199,70,104,1379,3843
19877,77,700,48,111,693,1629
8491,110,3635,119,157,1978,5999
38440,1407,2133,281,1601,8452,13874
14743,7,340,3,20,71,441
39339,55,322,26,52,656,1111
8101,1488,13826,785,996,9700,26795
48313,2,107,2,10,28,149
45868,2,11,1,23,23,60
3286,575,4394,317,291,1823,7400
2143,488,6139,311,223,5103,12264
9797,14,121,7,51,204,397
37292,437,610,225,169,1629,3070
11237,274,9155,175,158,3625,13387
35305,12,62,10,51,80,215
487,2137,63348,1660,2026,15195,84366
43343,0,3,2,8,11,24
24905,7,232,10,35,67,351
5029,330,14402,170,244,3588,18734
22607,12,204,12,59,111,398
361,190,2756,172,234,2739,6091
48406,15637,35784,3214,5081,35509,95225
30311,1480,28711,633,424,8704,39952
21471,45,921,20,34,288,1308
29317,2172,90205,733,453,18980,112543
534,6050,73295,5988,4744,37948,128025
2334,44,712,39,69,463,1327
2526,142,2195,75,75,1468,3955
11385,702,16219,571,905,5195,23592
9881,28,249,18,92,213,600
41008,264,7532,126,105,4656,12683
29383,8,43,8,46,62,167
34039,14,495,8,24,88,629
37127,1159,1378,411,269,1408,4625
43619,0,10,1,7,8,26
17513,12031,218948,5370,28200,41644,306193
153,7985,44881,6434,5477,63576,128353
34261,32,109,20,38,332,531
37387,16,287,4,26,150,483
43622,0,9,1,6,10,26
3439,179,1496,134,133,751,2693
24997,2197,87816,830,767,25907,117517
34677,8,87,4,60,37,196
29953,18,91,9,44,105,267
23033,920,9618,476,355,2788,14157
36056,6,160,3,29,50,248
49236,1751,26034,343,113,12762,41003
18139,14239,117357,8928,7913,53801,202238
103,781,5582,1089,1057,4856,13365
10136,18,147,11,71,103,350
7252,26,248,8,50,167,499
32949,38057,338989,16228,29712,163490,586476
1102,103,2081,69,132,1263,3648
36137,641,4219,331,258,1368,6817
1383,233,1024,123,169,1184,2733
32005,786,28014,247,300,5324,34671
1691,18248,289092,13347,17542,79389,417618
50401,0,0,0,0,231,231
44072,137,103,38,50,798,1126
1665,78,1173,66,112,922,2351
8324,25,228,8,44,261,566
1081,316,3164,224,173,3423,7300
43778,51,58,10,63,235,417
41081,23,48,6,35,106,218
42015,3,102,4,5,17,131
37755,668,1259,258,190,2605,4980
3258,168,3845,66,65,2799,6943
22827,14,126,10,57,177,384
23363,256,4309,242,237,3095,8139
7175,34,172,17,107,204,534
2308,296,1126,169,258,2272,4121
34391,1083,12068,390,224,5206,18971
4060,165,2029,132,179,1562,4067
113,898,11235,1000,1042,8288,22463
39570,5096,79196,2024,1475,24626,112417
43879,9,384,0,5,45,443
1988,463,4881,466,431,4201,10442
48221,2,4,1,16,25,48
31450,8,220,5,23,52,308
16814,14,90,2,56,110,272
5419,148,6342,131,94,2475,9190
23739,12,165,3,41,141,362
39827,7,55,3,29,46,140
20383,13,86,10,56,118,283
2712,20,134,9,59,242,464
45690,1,6,0,10,17,34
49220,0,0,0,0,5918,5918
6246,78,1636,64,76,1189,3043
22163,15,309,7,27,99,457
1058,72,785,56,76,784,1773
32309,349,5473,196,686,1938,8642
27457,14,200,10,79,69,372
29515,41,471,45,73,728,1358
29860,14,174,21,51,155,415
6231,170,8687,132,149,2283,11421
47992,1,5,0,12,15,33
45520,1,8,0,10,18,37
33686,92,2066,71,90,1235,3554
14333,651,1031,679,1222,2333,5916
5150,4595,47690,2856,3253,34438,92832
22377,240,3638,136,627,1628,6269
35605,24,58,11,60,107,260
12451,15,118,12,50,152,347
2608,3522,15081,2001,2144,10933,33681
36480,1594,32757,763,493,33292,68899
3981,198,1429,133,181,1013,2954
2929,196,2046,173,146,1975,4536
30930,8,34,3,47,40,132
4224,86363,1465850,50762,55265,264205,1922445
22849,78,183,26,76,788,1151
6583,27,159,16,61,198,461
21553,11,79,4,70,71,235
37209,507,1339,171,307,2236,4560
5549,82,1640,55,71,901,2749
7955,34,268,27,96,327,752
31196,553,6101,227,353,2089,9323
47958,0,4,1,8,12,25
39308,2,12,2,32,28,76
38529,2842,9778,1155,4803,14460,33038
44702,6,0,4,18,16,44
50337,2,40,0,1,8,51
34958,8,283,5,27,52,375
4849,154,1124,130,162,1299,2869
39109,5,58,7,41,100,211
33184,1836,5646,886,3573,10672,22613
50559,0,0,0,0,1051,1051
23975,17,217,8,39,143,424
36310,4,18,1,36,29,88
43246,0,14,2,6,9,31
23605,3259,10384,2661,6766,17364,40434
34565,5800,23104,2560,8017,24415,63896
3720,38,1038,17,62,380,1535
41070,11,252,7,14,129,413
782,992,6124,1003,1169,10366,19654
31439,2058,16299,808,3026,9431,31622
4513,119,2452,62,105,2007,4745
22239,14,196,9,40,157,416
10845,651,8061,331,271,4366,13680
42636,3,67,2,6,16,94
1983,93,2522,85,84,1664,4448
4493,217,1551,128,133,938,2967
28025,8341,271219,3352,1360,89469,373741
229,1255,17966,1545,2075,9348,32189
16476,248,1652,138,126,864,3028
7771,16,319,5,59,164,563
13407,13,348,5,30,110,506
50378,100,0,6,13,48,167
20111,15,63,3,49,96,226
31267,5,422,7,40,112,586
31561,281,15876,139,230,2856,19382
28869,266,3545,157,200,1535,5703
29708,9,60,8,54,80,211
33846,47,346,42,107,524,1066
30191,1251,40074,720,351,18542,60938
1445,583,7501,856,1522,2837,13299
340,1229,11730,790,870,7936,22555
39325,398,4529,121,147,2362,7557
41460,5,101,1,30,48,185
30400,10,275,5,41,80,411
39874,5,162,3,18,35,223
30947,156,1198,127,342,824,2647
50528,0,1,0,0,20508,20509
1919,229,2872,189,127,2191,5608
24743,139,940,86,113,581,1859
36027,13295,121526,4482,27875,44095,211273
34425,7,82,1,16,28,134
3532,222,1569,152,115,771,2829
31065,175,1330,82,100,1128,2815
6046,1164,28005,520,328,16543,46560
1174,478,10430,270,234,7450,18862
2292,102,1403,74,87,948,2614
17871,233,2811,111,86,2078,5319
39028,5,50,2,23,56,136
26019,233,3774,135,142,2330,6614
41178,3,357,7,7,35,409
39812,7,159,2,11,33,212
37866,70,2235,42,71,882,3300
43391,0,7,2,6,10,25
1368,160,11975,130,119,2255,14639
1212,1475,30193,1383,1297,11995,46343
5288,87,1896,93,88,1621,3785
32696,8443,62056,4544,6592,32895,114530
6758,4419,17403,3182,3907,30165,59076
6935,15,894,7,36,240,1192
46126,1,6,0,10,18,35
10589,1797,183536,801,518,17467,204119
85,4753,37656,2972,1184,15409,61974
42792,3,66,4,5,17,95
40484,20,60,12,34,134,260
37970,236,4179,85,98,2170,6768
2816,201,3371,165,255,1102,5094
3743,27,1519,15,53,312,1926
34957,8,240,2,25,119,394
36428,83,115,32,57,677,964
611,216,895,114,210,2118,3553
13089,11,320,7,34,106,478
37124,44,376,20,56,474,970
10602,16,69,8,44,175,312
7435,104,1062,53,92,1120,2431
38308,3,74,3,16,24,120
921,147,3475,133,98,1862,5715
51000,65,0,11,8,114,198
2686,157,787,213,460,1204,2821
3295,255,1270,319,442,1872,4158
2796,50,2365,33,134,585,3167
29347,24,1427,20,58,394,1923
8244,35,28,11,76,124,274
40750,62765,267809,8779,39837,70251,449441
27839,9,30,3,48,84,174
35241,11339,51277,5369,7896,56281,132162
35135,277,1917,158,131,8521,11004
32737,46,643,29,81,475,1274
858,252,1425,230,400,2059,4366
2606,187,9075,175,171,2902,12510
348,637,9273,870,1504,5278,17562
15565,6444,89391,2834,4814,31506,134989
40394,420,3074,108,111,2545,6258
45562,4,31,4,10,30,79
3950,79,683,50,87,430,1329
23343,17,115,5,41,147,325
9001,102,4487,48,52,2307,6996
755,488,13205,239,583,2380,16895
36545,409,3304,161,152,2538,6564
13239,135,5559,68,116,2432,8310
4083,51,370,51,105,391,968
41439,710,1442,164,262,1242,3820
29927,41,915,31,71,806,1864
27845,11,46,3,50,57,167
43380,0,6,1,6,12,25
33133,14,82,12,90,85,283
1085,474,6042,312,299,5638,12765
24085,16,58,6,46,154,280
42844,4,50,3,3,18,78
37501,78,1614,52,94,1359,3197
39410,39,49,18,46,131,283
1755,58,1819,39,68,672,2656
24795,5,67,6,54,65,197
2309,83,1949,54,88,970,3144
41158,7,29,5,16,41,98
7179,363,2603,216,189,1547,4918
43196,2,6,4,16,17,45
10488,918,5382,465,361,2620,9746
50009,0,40,3,5,10,58
33605,6283,34978,2522,5866,29367,79016
17127,145,771,102,415,878,2311
36466,655,29029,308,247,9856,40095
39377,2,26,4,42,30,104
10256,176,1038,88,81,546,1929
9389,24,271,14,53,206,568
10048,129,2819,70,138,1585,4741
13029,170,815,135,342,974,2436
6500,19947,143885,13228,33109,85657,295826
32700,191,5101,104,127,1891,7414
4182,1347,107687,745,427,20371,130577
3637,69,294,36,100,369,868
37095,3684,206937,1163,484,48171,260439
12061,85,471,50,93,442,1141
41848,3252,8000,907,583,3640,16382
19575,335,5940,157,166,2779,9377
1142,2236,63649,2036,1345,29288,98554
7472,2255,107403,999,759,29516,140932
39531,2191,14378,1016,2405,17883,37873
2802,66,1301,48,82,802,2299
30481,32,244,48,69,552,945
1920,156,5662,113,100,2753,8784
21933,12,113,3,64,77,269
6851,10,749,3,42,91,895
29451,8,203,1,31,39,282
32518,1003,3440,434,275,2022,7174
234,200,1985,179,311,1153,3828
36913,56,1213,28,64,657,2018
3080,138,7572,70,93,2254,10127
35402,12,570,4,40,86,712
24687,1789,58063,788,386,27502,88528
29730,460,2833,259,206,1201,4959
48031,0,5,1,12,12,30
38483,27842,242119,7650,12996,82301,372908
39310,15,51,4,25,131,226
30473,62,409,35,62,1059,1627
38049,10,91,4,17,68,190
48951,27,26,17,21,510,601
38473,63,1331,23,54,430,1901
246,5520,44354,6983,7619,27594,92070
49091,3,59,1,4,16,83
6031,111,643,41,78,917,1790
1686,2187,225611,945,603,17202,246548
33222,3663,43667,1487,3437,12887,65141
35219,36,167,30,111,769,1113
7708,1589,3877,587,452,2695,9200
45538,1,11,0,10,16,38
38292,492,9972,163,130,6813,17570
1052,88,742,58,109,832,1829
33937,18,330,7,24,123,502
43278,1,13,0,8,10,32
19231,15,704,5,28,105,857
37786,21160,128976,9062,8671,102747,270616
40345,6,125,3,11,42,187
328,293,3580,345,673,3338,8229
25065,28,361,20,45,345,799
2048,469,3016,290,189,4418,8382
6452,71,332,45,114,734,1296
44189,178,3635,57,84,525,4479
42793,8,229,2,11,38,288
50484,1,23,0,3,6,33
33388,17,67,15,44,302,445
2506,306,2765,176,176,1374,4797
9595,69,676,59,45,1462,2311
50281,1965,0,63,100,1998,4126
32802,437,5298,178,320,2014,8247
38100,97,78,38,64,832,1109
35516,107,159,33,181,523,1003
894,654,102106,337,279,5237,108613
40196,3475,11754,1290,4315,13068,33902
36529,53,460,49,86,2038,2686
17573,140,2199,91,94,2489,5013
50057,3,74,1,3,12,93
5423,57,289,29,72,255,702
344,324,4347,452,418,3940,9481
40052,59903,255833,25389,14598,145051,500774
2875,375,3373,233,204,1408,5593
10905,105,2016,83,99,1425,3728
1573,708,6070,713,852,4043,12386
6261,23,194,15,77,137,446
1964,112,1731,93,106,1524,3566
23825,21,436,9,38,231,735
39826,93,2663,45,89,958,3848
8595,23,88,10,59,152,332
691,1443,3404,1329,880,10639,17695
29349,6,87,1,30,60,184
3784,6223,363316,2456,1040,79349,452384
32345,15,271,3,32,74,395
35389,9,243,1,28,48,329
5923,49,215,37,65,545,911
33865,1493,4645,618,530,1797,9083
3768,60,210,42,108,483,903
43497,0,9,1,6,9,25
42685,337,2590,134,191,2438,5690
8086,16103,163233,9329,9059,74106,271830
22791,8,68,4,42,80,202
17665,11,87,4,52,117,271
6594,37356,225635,25297,15065,202773,506126
6959,62,3077,57,63,1228,4487
47769,1,11,1,9,13,35
29719,9,71,7,36,52,175
50396,1,43,0,2,12,58
29742,8,53,4,32,48,145
41762,8907,27076,2725,6439,19154,64301
6629,49,288,30,118,271,756
34393,1356,11199,605,2983,8188,24331
24543,1191,40981,539,286,20866,63863
31756,1463,39526,578,474,14700,56741
42873,2,68,1,9,20,100
2578,35,672,37,153,182,1079
49146,10,111,12,25,573,731
10851,6446,45188,2294,4116,12607,70651
4075,64,1387,50,54,907,2462
477,7805,51062,7465,5809,73150,145291
50049,2,14,2,13,17,48
879,1776,12410,1828,2234,20675,38923
43368,0,3,1,9,11,24
33082,818,43442,295,237,9074,53866
36603,50,1030,14,21,244,1359
15067,19,169,10,54,198,450
39281,11,389,2,13,44,459
6705,338,4109,179,144,2863,7633
39500,2,148,0,9,25,184
4675,127,956,66,110,569,1828
6312,97,1524,80,61,1187,2949
37586,109,640,51,114,2484,3398
39819,2585,36362,846,334,16551,56678
20075,35,263,25,108,155,586
16800,8,64,6,42,84,204
22055,67,891,61,98,730,1847
15323,1097,51031,369,399,6938,59834
2612,71,1082,90,217,340,1800
42262,3,55,1,24,40,123
2384,66,1291,43,56,731,2187
40282,9,896,6,35,92,1038
43004,1,74,2,9,15,101
6730,13,140,8,75,87,323
208,1271,41515,891,648,16384,60709
42194,340,1404,137,149,3358,5388
29933,8,330,4,18,53,413
31403,297,2095,161,170,867,3590
30196,181,2417,79,82,2160,4919
34118,10,287,1,23,67,388
30738,14,229,13,67,294,617
8777,30,177,28,79,310,624
11189,18,814,10,32,213,1087
29479,9,48,2,53,43,155
38511,8,133,0,14,38,193
39146,2,23,1,36,28,90
45861,1,5,0,11,19,36
39375,3,20,6,24,35,88
39133,3,22,1,26,28,80
29671,10,189,2,32,63,296
39180,9,158,1,12,52,232
38672,50,1046,48,78,933,2155
9973,9,232,7,75,114,437
37180,11,104,7,58,105,285
35979,12,182,2,18,41,255
37736,570,1373,209,289,2197,4638
19115,743,11371,405,214,15352,28085
21363,693,2777,332,276,1669,5747
19905,17,75,8,48,173,321
37141,57852,308772,36917,33783,125431,562755
42757,1726,2,580,299,1163,3770
6065,39,220,18,58,340,675
1017,2464,17960,2023,2043,15614,40104
37171,30105,210368,14252,13938,115105,383768
26349,11423,220070,5345,6901,69256,312995
3902,124,800,86,92,498,1600
41899,35904,169552,5073,17556,54569,282654
39991,322,17834,129,67,4196,22548
193,4057,61241,3184,4497,18191,91170
40989,141,658,68,99,1463,2429
3385,234,1913,165,178,1193,3683
49876,58,176,27,28,180,469
50008,2,132,1,7,14,156
42585,9,82,11,22,107,231
18425,18,384,4,35,91,532
31564,4007,24566,2120,3159,24215,58067
3031,222,14807,204,188,3622,19043
4450,203,5381,239,240,4257,10320
16498,174498,2884951,44665,51665,151425,3307204
10906,531,3073,317,272,1897,6090
6182,44,673,35,54,1015,1821
3596,36,477,16,46,332,907
20903,1099,34160,464,206,17500,53429
30567,501,13422,193,219,3302,17637
1898,108,1922,60,58,945,3093
43692,17384,200787,3763,10354,60793,293081
36588,122,161,34,62,316,695
38901,2,168,3,13,34,220
15219,137,3847,126,160,2609,6879
26335,14,75,3,39,99,230
38752,4,104,2,8,27,145
33323,1110,40323,383,232,10874,52922
1011,351,12723,233,170,3871,17348
42438,7,248,5,8,38,306
36848,2345,15120,888,898,9195,28446
33438,100,92,55,56,1389,1692
49825,4,242,0,6,27,279
2267,134,4461,120,118,2855,7688
631,159,8063,138,93,2133,10586
22991,9,85,5,69,72,240
32729,40857,417643,20301,26349,197391,702541
38324,1,107,1,17,25,151
2828,623,4999,515,422,6150,12709
19029,332,8037,218,203,3192,11982
39166,445,5288,177,53,9782,15745
29379,6,44,8,47,62,167
11321,1981,15971,915,725,5790,25382
38938,4566,31396,1475,1512,30076,69025
289,584,9690,807,1070,5905,18056
23643,11,129,5,54,91,290
5558,117,703,69,112,541,1542
35118,412,8949,249,221,5246,15077
38474,21300,70878,4566,1506,71983,170233
35453,18,92,5,35,117,267
618,1382,20258,1091,1664,13126,37521
49668,2,127,5,13,50,197
34901,833,8816,335,583,2238,12805
28051,21,535,6,56,114,732
21853,185,4970,152,191,3229,8727
36624,21,282,11,58,218,590
1272,490,4386,357,495,2259,7987
44203,32073,141284,3127,7556,50712,234752
47638,1,101,1,11,19,133
43444,10,248,3,10,84,355
29943,26,1729,12,34,311,2112
6152,217,7719,125,147,2882,11090
40165,5712,15439,2325,13918,19993,57387
3075,57,643,59,155,399,1313
39164,55,3837,6,30,199,4127
16526,19,88,14,72,151,344
40552,2,47,3,19,26,97
4608,124,921,70,118,836,2069
36071,9,129,2,14,34,188
2353,164,2276,126,123,784,3473
40040,43,142,18,91,270,564
30512,31,97,25,41,625,819
24683,14,69,2,62,76,223
7021,14,541,7,37,129,728
9416,12,155,5,55,125,352
30408,10,164,3,41,59,277
3091,4276,81806,3214,2256,36703,128255
17823,42,261,32,90,297,722
35069,1603,7740,629,3458,7974,21404
5541,43,269,30,77,169,588
4800,54,854,60,106,471,1545
25029,24,205,12,42,244,527
35281,9,24,1,38,34,106
33062,6,97,2,35,41,181
371,784,78603,498,292,10306,90483
5454,1322,10252,1105,1717,9488,23884
2682,68,1351,49,79,692,2239
1056,134,4540,70,84,1478,6306
40616,3,130,1,13,45,192
43371,0,5,1,8,15,29
40845,99,2687,40,98,1838,4762
31258,8,368,4,27,81,488
9379,14239,148147,9593,10639,96848,279466
6206,15,52,6,48,106,227
28517,323,2804,209,161,1029,4526
2315,151,1855,75,115,933,3129
33663,30,193,5,26,151,405
10897,1451,96498,730,472,16207,115358
40835,244,1538,97,104,1549,3532
7112,59,596,40,58,1068,1821
37599,3384,11381,1213,3329,12889,32196
36231,55,58,17,118,294,542
10764,342,3809,199,219,1061,5630
43364,0,8,2,6,12,28
6547,65165,1421289,40493,46813,285657,1859417
38756,6,423,2,24,46,501
49431,103,43,22,43,2672,2883
31298,339,7849,260,213,3615,12276
15097,2500,13554,1070,749,6222,24095
31831,10,497,5,24,97,633
34336,17,107,12,48,142,326
35602,362,12673,180,185,3513,16913
7090,21,197,9,41,194,462
34550,1431,6558,945,3933,4241,17108
32534,131,1094,46,86,1122,2479
6067,93,240,47,96,671,1147
39948,1700,7355,571,728,12083,22437
45658,268,1772,85,127,1322,3574
951,859,5167,1002,1299,2222,10549
6030,6970,73300,5424,8431,40019,134144
995,910,34857,567,442,5464,42240
8898,49,592,20,48,480,1189
7337,525,45707,309,304,9564,56409
3972,9036,81303,8648,10346,13087,122420
33856,11,38,2,36,68,155
37938,258,116,78,97,607,1156
2634,53,1843,35,96,448,2475
433,4868,106151,2380,1344,81859,196602
42668,4368,18798,1914,3997,20571,49648
23265,24,470,9,61,120,684
125,1129,20754,1007,1553,8825,33268
390,4277,63965,3524,4627,31173,107566
40357,0,0,1,0,200703,200704
42432,9,272,7,7,57,352
32247,46,1045,27,50,455,1623
38907,10,147,6,38,57,258
1144,270,10940,193,113,3454,14970
6226,108,1909,82,150,1650,3899
40239,742,21981,205,416,4615,27959
41325,13,221,9,16,139,398
124,294,12289,241,246,3526,16596
36715,28,388,20,70,325,831
46431,0,5,0,0,60195,60200
33705,17,169,20,60,168,434
14173,295,10873,143,112,3170,14593
34870,232,7560,107,113,2364,10376
4044,89,521,90,165,775,1640
48627,56,1157,39,36,2007,3295
31231,268,24232,191,175,4275,29141
30549,697,6951,318,323,5276,13565
1026,128,1775,73,88,1875,3939
40539,4,58,3,18,26,109
32557,17,164,4,46,89,320
39141,68,126,22,58,250,524
24047,18,148,9,32,91,298
46488,0,0,0,0,3070,3070
30073,5,230,2,30,44,311
50681,32,0,6,31,44,113
43236,0,15,2,7,10,34
42149,26,129,11,29,111,306
19717,16,107,7,48,108,286
25393,28,409,19,37,277,770
20703,8,83,4,36,71,202
760,419,14551,270,235,5720,21195
43531,2,49,3,20,21,95
27655,9684,228290,5450,9643,35066,288133
30547,338,4680,121,67,3427,8633
20507,76841,1434123,38681,30305,301073,1881023
3616,1933,22386,1647,2557,10111,38634
1872,71,359,68,147,476,1121
9062,39487,166620,10255,4197,32389,252948
10013,51,612,32,58,748,1501
36109,758,4678,249,251,1656,7592
28779,884,13716,438,454,2498,17990
40476,10,260,2,13,93,378
43656,0,13,3,12,10,38
15325,560,18418,268,361,5150,24757
42249,220160,408082,26654,29006,172932,856834
5234,25,153,18,111,334,641
380,352,16712,294,227,3834,21419
6690,833,4389,434,361,2191,8208
16201,9795,76885,7288,16547,79893,190408
34647,241,11292,163,266,2762,14724
34455,577,1407,174,203,4867,7228
43629,0,0,0,0,7691,7691
4011,274,1742,151,178,1139,3484
40483,13893,101930,4104,7955,38001,165883
5996,83,4801,66,107,1442,6499
41105,227,3997,101,137,3155,7617
40154,511,5633,266,364,3535,10309
36043,1137,80599,378,230,10207,92551
38688,84,161,22,68,324,659
33354,16262,41926,6846,5317,35469,105820
37243,26,331,6,34,146,543
38062,5781,26031,2563,5604,26614,66593
403,1232,18073,851,1233,7811,29200
4540,113,2798,70,109,1711,4801
35962,30,0,11,41,64,146
34666,11,51,4,45,47,158
23009,12,86,8,81,153,340
30212,13,669,6,31,105,824
33782,44,53,12,117,251,477
718,301,3326,202,265,2561,6655
20085,17,63,12,53,149,294
7054,50408,814573,28896,30797,166563,1091237
38549,112,708,69,168,495,1552
36473,215,3356,104,132,2364,6171
40876,174,214,61,69,1260,1778
49738,10331,16187,2118,2713,25229,56578
48483,69242,138836,8253,13329,105021,334681
2300,63,2135,53,87,1329,3667
2399,39,1177,31,74,611,1932
1526,517,98021,270,274,4223,103305
15881,1285,23315,646,595,9313,35154
22097,7952,77750,3488,1790,25409,116389
23361,348,9142,358,229,5463,15540
1839,50,715,77,166,349,1357
40407,2,31,4,21,44,102
37202,20323,76476,9168,21042,51834,178843
6201,9759,140421,4654,6589,40204,201627
14821,18,106,4,62,133,323
31143,1541,17343,785,2310,5772,27751
17699,154,3916,98,112,1932,6212
33362,949,8039,497,658,5362,15505
35035,10,51,1,35,47,144
39330,4,121,1,9,21,156
37773,523,12602,214,150,12403,25892
41100,14,0,13,29,51,107
34915,1705,6955,895,1224,8695,19474
36090,9,181,4,15,52,261
36761,84,378,41,82,1485,2070
6557,42,423,30,51,536,1082
254,240,8820,232,205,2198,11695
37350,8,116,0,16,35,175
33174,7,54,1,48,54,164
12237,242,1942,120,202,2526,5032
19875,16,217,13,105,121,472
6198,116,9536,119,124,1977,11872
5693,22,112,14,44,145,337
17679,168,4895,79,65,2816,8023
43668,0,7,2,5,10,24
34734,68,2399,29,66,1046,3608
39397,524,8598,167,179,3553,13021
45557,85,134,26,72,355,672
5208,149,1133,110,133,1028,2553
43697,3792,38660,1152,4599,15737,63940
23537,6,62,5,65,87,225
43805,0,10,1,5,8,24
36669,13,168,2,27,59,269
36600,21,774,7,16,156,974
3062,331,2472,210,212,1072,4297
40638,91,136,27,52,265,571
6579,22,235,11,44,176,488
10458,792,5231,401,383,2618,9425
9886,9,90,7,47,105,258
24437,40,367,14,87,224,732
1487,290,16038,253,256,5663,22500
18631,19,65,15,36,184,319
40153,11,186,6,18,82,303
40567,61,107,11,75,307,561
11355,423,16563,190,254,7434,24864
9521,44,457,16,81,342,940
35557,21238,190269,9092,8276,147302,376177
33569,1904,32728,840,1085,10953,47510
42395,12911,34274,3238,6724,28451,85598
50183,0,0,0,0,1058,1058
36524,529,17930,176,352,3828,22815
37823,8832,40309,3177,22811,28822,103951
40480,50,1661,18,47,476,2252
23369,217,9580,198,193,4382,14570
38073,6,94,6,37,47,190
34349,258,6334,130,139,2821,9682
43663,0,11,1,7,6,25
3861,484,11851,398,310,5892,18935
48096,0,4,0,9,14,27
8717,7,369,3,30,125,534
17157,1457,35126,600,578,9896,47657
14125,11,213,4,36,53,317
29587,8,219,3,41,53,324
997,551,40393,347,269,7272,48832
34726,28,34,4,46,69,181
1816,3023,48065,3719,6187,5998,66992
593,1829,13130,1730,1516,21734,39939
43373,0,8,2,6,11,27
23157,11,363,6,25,127,532
797,181,6888,146,122,1866,9203
17913,44,2605,14,30,322,3015
50,6528,90947,6986,8496,33895,146852
37642,29,114,7,39,149,338
37517,16676,128644,7994,14835,77769,245918
375,301,3304,366,399,2577,6947
5104,40,499,36,102,311,988
33572,612,1697,303,930,4532,8074
1008,263,13126,213,156,3629,17387
5209,598,3190,313,262,1850,6213
7522,118,525,121,159,491,1414
2289,62,1261,58,68,779,2228
13087,10,286,8,39,101,444
980,247,1494,253,418,2260,4672
33855,74,560,51,82,1157,1924
19957,15,156,6,51,125,353
3375,1270,43138,407,640,5047,50502
43919,8,266,1,5,20,300
2689,38,632,34,56,481,1241
40957,475,1725,116,265,1947,4528
10585,8,483,2,31,65,589
50101,2,17,2,4,4,29
2180,121,1070,85,98,1460,2834
44159,0,10,0,15,11,36
40753,22,195,23,35,385,660
1407,263,2673,127,171,1535,4769
48257,1,9,1,19,22,52
13173,99,3477,60,59,1446,5141
23317,5487,157474,2172,1684,48751,215568
33983,3120,15039,1781,3038,14125,37103
5900,38,263,18,66,494,879
9606,10,60,3,51,60,184
836,1498,10144,1188,1937,8014,22781
30845,91,1659,59,110,1153,3072
10349,53,247,32,113,162,607
29954,13,462,7,27,92,601
32561,890,40172,362,284,9300,51008
39722,15,214,13,16,1055,1313
8501,14,112,10,89,147,372
16331,146,6003,47,59,1642,7897
2979,136,1422,86,152,696,2492
24037,3271,48336,2443,2458,17003,73511
1941,442,3504,399,529,5193,10067
5408,104,651,70,90,466,1381
35239,27,93,15,60,386,581
11197,14,74,8,55,95,246
25983,18,84,6,33,158,299
50668,0,0,0,0,3577,3577
1818,25650,360204,21645,22012,174711,604222
29904,11,403,2,34,143,593
6127,2422,73104,2224,2665,19640,100055
50150,3,61,0,1,14,79
6965,23,240,10,47,162,482
40721,6,335,2,11,47,401
40599,5,85,2,13,36,141
48755,823,6907,326,251,1991,10298
40453,1361,58755,455,279,17112,77962
40655,4,103,1,12,20,140
35532,8,91,0,15,29,143
40784,1862,30424,504,362,8668,41820
49514,4140,1,295,2222,7261,13919
7466,17,813,1,33,133,997
557,144,4526,109,108,1540,6427
31765,10500,520961,2561,2371,92056,628449
35111,1505,39160,543,486,19162,60856
21955,12,89,5,58,65,229
38021,148,292,67,81,2236,2824
23607,13,87,10,66,137,313
20589,693,2899,290,212,1345,5439
16564,19,234,9,78,148,488
38795,7,199,1,14,38,259
1562,6798,95264,5731,7254,32060,147107
23281,20745,403028,12382,13658,133152,582965
17341,340,13999,170,135,4228,18872
98,3784,62732,3816,4456,32826,107614
35395,13,260,2,29,44,348
47762,0,4,0,9,13,26
622,244,4448,158,151,3073,8074
18691,1834,7051,793,564,3914,14156
30123,31395,360779,20113,21057,140102,573446
3308,305,2172,186,189,1357,4209
34504,1682,28580,701,311,19937,51211
43636,0,7,1,7,9,24
37760,769,8050,182,141,5974,15116
34817,18,183,2,56,129,388
34204,896,10101,587,276,6708,18568
39093,125,3521,42,67,1219,4974
21647,9009,194756,3104,1368,115414,323651
35026,9,45,1,41,38,134
8522,17,87,4,50,114,272
8081,25,226,8,51,257,567
26237,13,48,9,51,98,219
1104,295,4090,205,187,2770,7547
2881,75,856,49,55,1051,2086
16912,19,344,17,66,267,713
27989,20285,200216,12224,10103,152701,395529
594,776,72850,444,368,8052,82490
41786,3,68,1,8,18,98
33938,8,98,0,16,30,152
307,48,606,53,152,254,1113
469,5855,116081,5250,7490,31692,166368
34182,11,37,1,48,42,139
29868,86,1883,56,88,1124,3237
29918,9,162,6,38,86,301
535,1858,48108,1457,971,11969,64363
34437,4617,144336,1624,1082,117130,268789
21295,12,109,3,65,76,265
40427,2,56,1,11,31,101
1168,355,4739,351,210,2810,8465
44164,0,8,0,9,11,28
30782,4393,44980,1848,7196,19468,77885
2795,4187,38845,3616,6043,18130,70821
41814,70,61,31,24,1784,1970
49297,668,13596,157,166,6000,20587
18937,15,130,13,71,100,329
39892,3,112,1,14,18,148
3625,162,3501,74,116,2850,6703
34979,113,347,42,182,281,965
42882,31,273,7,19,185,515
5984,1994,14497,1721,2166,21287,41665
13431,31,149,19,100,190,489
49065,1,16,0,12,19,48
1677,50,1166,55,66,863,2200
116,693,8774,677,726,5229,16099
46650,31,366,21,28,448,894
709,1370,10835,1188,1016,11609,26018
7014,228,3675,138,91,4226,8358
6419,61,319,34,65,608,1087
9495,33,323,19,50,598,1023
5925,44,869,21,45,593,1572
515,142,2703,84,98,1804,4831
17585,192,4807,118,96,2018,7231
2804,124,879,97,178,1130,2408
1643,63,902,33,63,619,1680
24699,2552,12084,1617,3117,12565,31935
7980,17,151,14,100,133,415
4799,174,977,114,113,711,2089
36272,8,22,3,31,36,100
35842,4708,28540,1873,1825,47571,84517
37449,8861,50817,2956,2194,36305,101133
5661,24,988,7,59,174,1252
2072,81,846,55,116,813,1911
24591,80,3892,40,100,909,5021
22181,30,536,8,30,144,748
8057,794,10996,531,474,6506,19301
42863,3,66,2,7,18,96
29907,8,504,4,27,128,671
29778,13,913,10,20,140,1096
1603,349,3384,357,449,2694,7233
34813,20,142,15,38,157,372
39056,14,303,6,18,97,438
2552,192,483,181,248,1254,2358
1910,375,3058,231,139,4699,8502
38290,9,179,0,15,50,253
13261,1776,39321,999,1588,5075,48759
35226,53,26,21,154,136,390
48318,3,11,2,14,56,86
2109,445,5178,384,305,2342,8654
49139,1,20,1,6,17,45
40728,5,100,1,15,55,176
599,192,2336,139,118,2375,5160
521,2749,50517,2774,4354,9717,70111
43435,7,126,2,6,20,161
7455,214,1160,131,126,826,2457
32166,8,54,2,53,46,163
38287,5,64,4,19,30,122
46420,1166,22656,615,238,26697,51372
10958,283,4696,147,404,2261,7791
21031,97,2412,53,99,1101,3762
47768,0,6,1,15,12,34
1826,1727,12488,1807,1874,8169,26065
36756,96,2453,85,151,1381,4166
13141,448,3883,319,886,3564,9100
13563,113,1046,44,65,833,2101
35128,13,181,8,52,200,454
39634,8,26,2,17,50,103
32821,8,97,4,75,47,231
20359,1588,36553,630,676,14575,54022
2168,119,1214,119,116,1375,2943
41448,3,85,3,6,22,119
356,34974,589389,22892,27285,176083,850623
1396,28,241,17,47,324,657
28433,12,1249,9,38,234,1542
11867,180,6288,95,118,3527,10208
39265,2,10,1,32,30,75
50789,0,0,0,0,456,456
36744,8,192,0,22,46,268
8213,31,391,16,94,167,699
27965,13,61,8,54,56,192
17785,23,458,19,48,330,878
12769,54,319,44,59,704,1180
17637,641,14283,445,492,6650,22511
6802,7445,60192,6202,6018,68242,148099
21635,620,26724,278,180,7000,34802
2814,27,594,33,114,179,947
33949,528,18712,221,134,7508,27103
41404,25,26,10,57,180,298
21821,1847,10163,1019,3223,8593,24845
33116,9,82,4,47,57,199
30911,23064,166939,10767,16220,81083,298073
49550,308,7276,78,137,1867,9666
23595,29,335,33,63,460,920
25871,29,322,21,55,139,566
48751,12,36,5,21,54,128
36396,10,87,2,26,27,152
49410,343,310,130,86,2115,2984
12131,238,2930,169,190,2480,6007
35205,15,43,6,42,67,173
28733,37,348,37,50,555,1027
1302,201,4456,144,122,3365,8288
47798,1,8,0,8,14,31
41135,13,319,4,29,134,499
3399,163,559,151,175,1180,2228
23593,14,58,4,38,103,217
12521,17,439,1,22,103,582
7338,5565,182840,2902,1590,45694,238591
2440,110,1131,74,85,534,1934
2827,77,2716,108,373,491,3765
18033,13,171,8,45,116,353
28339,24,1885,11,68,288,2276
43499,0,9,1,6,11,27
43703,2,33,5,24,39,103
4553,19,162,10,66,130,387
3956,627,30715,560,402,8224,40528
39306,6,130,1,13,53,203
28543,9,68,2,62,47,188
16904,5099,163335,2099,1753,61154,233440
49295,642,1667,198,176,614,3297
44162,0,8,0,9,16,33
40559,11,374,4,8,45,442
40803,6086,15994,2264,5075,20370,49789
7523,18,404,8,77,174,681
31318,7869,48239,5429,18303,22202,102042
5535,43,340,13,40,371,807
20095,15,89,7,44,105,260
3199,167,2528,161,274,1940,5070
48605,14,463,9,19,98,603
8450,44,258,34,53,914,1303
21761,9,85,22,106,85,307
32832,62,143,36,49,1112,1402
5597,2868,15649,2184,2922,25433,49056
8705,244,2814,184,226,3772,7240
16554,8,84,8,47,92,239
27881,663,3240,336,315,1499,6053
39172,4,200,1,15,35,255
3115,121,1276,54,65,1989,3505
22569,16,160,5,45,105,331
808,214,3529,159,162,2014,6078
36841,21,664,7,14,128,834
49652,324,1626,113,88,959,3110
30094,13,205,5,35,66,324
1494,196,5205,128,124,3329,8982
25867,5972,28576,4813,9549,34707,83617
39369,10,240,9,43,140,442
2605,18233,139910,16702,11818,128764,315427
37529,7,127,1,18,52,205
36602,21,773,6,15,155,970
8023,1039,30860,700,438,10726,43763
30583,723,10099,320,348,2107,13597
40155,45,8,29,39,71,192
13807,1948,99784,803,737,25694,128966
32789,12,474,5,32,72,595
10842,461,10897,538,407,9464,21767
9768,38,298,29,136,189,690
37453,2,219,2,13,39,275
4163,1182,37639,646,367,9985,49819
34776,312,2990,158,131,3889,7480
33338,1006,48442,377,234,10655,60714
11879,1659,23098,756,621,4628,30762
40800,1,108,4,6,18,137
16808,13,117,3,65,101,299
8768,1848,67191,634,452,19085,89210
50672,0,0,0,0,9149,9149
27461,11,102,7,51,50,221
4252,61,651,36,48,601,1397
44065,321,339,52,69,889,1670
40336,664,3589,287,234,1330,6104
36807,7,76,1,13,21,118
2813,184,3771,238,414,746,5353
39473,0,0,0,0,2162,2162
29491,10,45,4,51,57,167
48129,2,10,1,19,30,62
45705,1,7,0,12,19,39
49751,7,249,2,3,20,281
255,175,7130,191,140,1865,9501
42366,2,21,1,17,40,81
21039,4035,33340,3316,3577,24745,69013
50399,0,0,0,0,10032,10032
24075,4389,44335,3559,5818,22649,80750
9968,535,3194,291,245,1721,5986
450,975,80890,596,282,11831,94574
3723,35,405,30,107,188,765
35230,174,348,61,97,1345,2025
7029,18,710,11,44,202,985
25601,14,57,3,59,93,226
1183,199,2108,115,155,1658,4235
19021,1687,65846,1060,632,24660,93885
42629,157,5250,80,50,1598,7135
6401,277,11985,237,190,5645,18334
32776,8,213,3,20,53,297
10770,630,3798,310,273,1857,6868
32276,15,47,4,53,101,220
22653,10,91,5,48,79,233
6779,40,429,49,122,197,837
41029,0,0,0,0,1889,1889
2897,34,2105,26,46,775,2986
31369,33,60,14,53,152,312
39394,3,202,3,11,28,247
33980,22,46,5,50,154,277
28979,9291,166589,4207,3747,44885,228719
8109,35,977,27,70,609,1718
3962,386,6470,405,811,4001,12073
18097,1556,31393,891,1694,5075,40609
29917,9,154,2,48,65,278
1498,2971,69500,2798,3197,18462,96928
34140,57,253,15,60,417,802
10335,24,133,8,35,225,425
38091,2075,9010,1101,3859,8310,24355
798,516,4795,420,445,6718,12894
4462,17,1239,6,42,105,1409
8663,15,611,13,49,238,926
35559,476,5240,167,283,3174,9340
32572,335,356,196,321,1415,2623
12279,41,544,20,70,443,1118
39155,1,8,2,30,28,69
39035,11,353,2,17,55,438
35350,13,66,2,22,31,134
41920,79,138,24,78,230,549
36398,10,107,0,16,24,157
3129,54,532,51,150,334,1121
2493,38,1072,42,76,691,1919
49524,304,2119,127,113,736,3399
21703,92,3403,84,130,1301,5010
29889,6,85,4,55,56,206
42640,382,4042,89,102,1814,6429
39198,15821,144110,5808,7748,79340,252827
51019,1,0,1,1,31034,31037
6735,53,689,40,64,781,1627
2061,72,1838,51,50,878,2889
10490,15308,173001,9056,16741,100930,315036
40733,452,1166,112,84,2547,4361
26147,7,40,4,48,52,151
5225,145,6115,99,110,2591,9060
39798,11,72,3,68,50,204
37506,22,325,3,23,186,559
47991,0,4,0,10,12,26
34328,21,119,5,26,91,262
23583,41,442,16,75,441,1015
16143,355,10241,233,249,4145,15223
33703,22,69,4,49,136,280
8373,45,2368,53,173,302,2941
32989,51,212,32,72,542,909
9868,17,136,9,63,101,326
42787,1,68,2,8,21,100
11977,2554,130017,1439,991,44073,179074
35983,8216,40902,4302,9479,34166,97065
20723,479,7124,451,371,2058,10483
33314,1423,5057,983,1721,3648,12832
9035,77,1774,52,80,1191,3174
11997,748,4824,388,295,2217,8472
25,7079,58012,6678,8674,43140,123583
21325,984,11784,635,1002,5354,19759
2533,236,1893,145,180,965,3419
21729,620,9818,382,520,2768,14108
30973,8,123,15,85,81,312
18907,9,52,3,52,62,178
31051,1914,73247,502,424,11968,88055
40568,55,229,18,42,389,733
2895,105,588,81,108,2553,3435
426,303,8154,360,456,4907,14180
27493,12,81,7,59,72,231
41918,186,315,28,52,427,1008
6230,87,195,38,62,900,1282
30781,12,116,0,43,64,235
6974,5461,48799,3914,5446,32513,96133
6791,1025,29951,558,426,9485,41445
12439,34,306,8,64,382,794
10549,83,2171,45,88,1129,3516
32898,71,1227,49,77,782,2206
16970,32,122,17,51,256,478
7304,318,16300,136,209,2357,19320
35073,40337,662083,10478,10813,96756,820467
36082,9,128,2,11,25,175
39979,281,396,246,453,2000,3376
45577,1582,4343,288,353,7642,14208
956,115,761,99,149,993,2117
34412,61,1705,26,65,707,2564
33925,103,193,33,73,372,774
38507,3,133,1,9,23,169
7449,7,260,5,29,82,383
7268,519,3250,288,248,1714,6019
39124,3,23,1,29,31,87
37950,4,25,5,43,46,123
4536,64,419,49,109,480,1121
10804,118,5986,84,69,1776,8033
43532,3,83,3,6,16,111
10820,25,251,11,58,304,649
16373,29,302,13,74,226,644
8423,81,1663,76,133,1711,3664
3676,111,379,108,123,963,1684
10562,60,305,33,108,316,822
10029,2125,120898,1014,399,37197,161633
5216,330,10076,257,195,4208,15066
3965,235,21447,220,121,5118,27141
38540,46,699,29,52,668,1494
18055,2389,39249,1294,1105,14528,58565
39057,52,1626,15,55,249,1997
17291,45,249,27,87,274,682
17403,27,237,17,75,469,825
48260,2,8,1,17,23,51
27519,39,144,26,89,246,544
865,330,1015,247,204,2975,4771
31426,76,1026,39,50,834,2025
10194,49,251,17,74,406,797
35525,9,125,2,28,29,193
15093,57,874,42,62,747,1782
39129,3,50,2,29,33,117
844,134,5373,119,108,2084,7818
743,1669,75372,793,473,27960,106267
2658,40,3171,45,106,582,3944
48569,139467,66,13750,3104,87717,244104
12685,840,49609,619,759,14408,66235
22623,10,104,5,42,82,243
43606,0,8,1,5,10,24
37442,1725,40548,794,299,31925,75291
21077,99,1495,75,133,1333,3135
9951,33,695,12,54,503,1297
22157,12,853,10,45,138,1058
36680,9,124,2,12,28,175
50955,0,0,0,0,1499,1499
7762,3481,13192,1619,861,10039,29192
42617,6,98,2,7,23,136
37733,7,175,2,25,73,282
37112,12,547,17,42,184,802
30137,1127,25423,402,780,9313,37045
37542,10,190,2,9,49,260
9212,19,104,17,46,289,475
50517,1,32,0,3,9,45
40344,10,1343,2,17,72,1444
33021,787,5789,244,1251,3825,11896
33004,1747,20632,926,687,10821,34813
7559,923,23489,650,683,13562,39307
22459,12,149,11,46,104,322
21649,139,2753,65,61,1514,4532
1540,74,2080,51,77,925,3207
37876,29,58,8,32,145,272
39095,2,233,2,19,44,300
4477,2831,90584,2123,1241,18974,115753
3622,554,2954,262,229,1544,5543
6064,925,28443,758,570,14764,45460
603,3250,20737,2938,2892,11509,41326
1300,177,1291,229,293,1668,3658
8937,16681,300349,10363,7786,80584,415763
36486,19,61,12,65,72,229
38413,162,249,45,84,1106,1646
38722,19,134,11,20,220,404
49889,0,0,1,0,51513,51514
41345,24844,107686,6431,20078,69893,228932
5781,11569,97937,4885,5425,58507,178323
2651,29,1561,32,84,421,2127
37392,8,125,3,40,50,226
35070,26,156,14,116,352,664
48262,7,18,6,26,53,110
18071,20,81,9,44,175,329
3325,165,672,126,151,1066,2180
41466,2544,14068,496,1892,7686,26686
35123,7,32,4,41,41,125
43534,0,9,1,6,9,25
43581,0,8,1,9,11,29
41447,4,228,1,8,51,292
1151,518,8457,340,323,5438,15076
39477,1152,11373,593,488,12730,26336
39087,7,113,1,13,25,159
37594,6,190,1,14,35,246
2244,138,453,101,146,1204,2042
2097,79,1660,46,68,985,2838
50486,1,20,0,1,4,26
29770,13,506,5,22,114,660
5755,69,873,36,67,703,1748
422,84,1940,67,60,976,3127
21523,59,1248,39,141,480,1967
37515,2015,41957,758,838,42965,88533
49618,0,0,0,2,6281,6283
39758,4,10,2,26,23,65
4936,396,6115,539,1334,806,9190
40358,3378,5692,1709,5590,10525,26894
6904,1004,23069,506,441,14200,39220
34860,7,173,1,13,56,250
31740,668,4980,361,390,1682,8081
7501,21,319,10,59,128,537
2818,134,802,102,154,886,2078
16830,10,64,3,58,62,197
1160,138,1879,69,89,1429,3604
620,1149,10549,1024,999,10664,24385
23877,42,1705,15,43,462,2267
28561,8,37,1,50,44,140
36667,8,119,2,12,24,165
43694,0,0,0,0,1267,1267
338,5147,28832,4302,2618,40360,81259
2351,293,2423,161,198,1312,4387
763,1578,31895,1923,2685,7319,45400
7844,14,139,9,44,274,480
27603,745,5320,378,303,1852,8598
3583,130,1040,71,100,587,1928
38138,15,80,3,73,51,222
3679,846,4372,467,399,2719,8803
45908,1,4,0,10,20,35
42562,462,1688,188,208,4335,6881
39385,3,100,1,9,45,158
31783,6161,43139,2887,1949,15482,69618
37222,583,1449,232,149,1035,3448
3367,74,996,38,54,1270,2432
48864,11,197,6,23,61,298
31710,12044,76409,6693,25676,35561,156383
32606,2035,11292,815,2821,11744,28707
519,1048,12766,937,1037,8049,23837
31733,2964,33070,1309,916,12461,50720
15399,24,84,11,45,231,395
2687,45,276,41,119,303,784
4063,15245,254942,8062,12632,78035,368916
893,482,45987,332,272,6217,53290
31007,9,32,4,38,51,134
38800,7,134,0,16,45,202
29425,37,16,6,58,69,186
1267,64,1139,46,72,799,2120
40156,197,2502,71,104,2491,5365
23365,14,1074,9,37,160,1294
9855,187,961,101,111,578,1938
649,847,14285,593,756,5227,21708
10379,8435,139387,4223,2222,71457,225724
8598,47,349,30,62,804,1292
4358,1217,13671,630,525,3508,19551
2630,41,1415,36,92,487,2071
2280,51,377,70,165,443,1106
5621,56,239,27,80,288,690
32455,1254,3863,460,1821,5614,13012
604,463,4485,508,573,4427,10456
20545,943,32947,394,214,9473,43971
44196,1000,2417,184,186,1850,5637
3680,427,3299,270,246,1810,6052
38297,13438,130099,3303,15239,32001,194080
38934,22,633,9,15,195,874
36804,9,112,2,27,35,185
3174,220,11331,239,161,2872,14823
40815,10077,103617,2366,1720,24156,141936
45533,1,6,0,11,17,35
38429,108,932,83,76,1964,3163
9749,20,64,3,42,109,238
12929,4650,19799,3089,7715,9407,44660
1638,138,2379,164,219,1132,4032
40045,58,133,29,94,423,737
18703,20,128,6,42,186,382
25755,234,6633,143,184,3721,10915
42314,4,156,1,6,21,188
31491,1969,10552,704,913,6303,20441
34675,2121,3831,860,1201,8016,16029
18829,12,158,6,43,115,334
15141,17,150,4,46,196,413
45522,2,9,0,12,19,42
17953,11,155,8,42,116,332
994,71,1606,40,54,1087,2858
1712,69,447,63,102,556,1237
30695,310,2222,150,214,7566,10462
1351,723,6873,361,456,7411,15824
7452,20,170,20,63,139,412
6073,18,214,14,99,205,550
1549,103,1761,91,110,2040,4105
9257,78,345,62,103,435,1023
3479,1601,11022,694,660,4818,18795
4868,161,937,86,129,760,2073
38008,18,34,9,81,96,238
50338,0,0,0,0,7401,7401
427,3541,40332,4307,4064,24637,76881
3577,1844,11325,1908,2266,10078,27421
30741,763,3522,410,289,2064,7048
17749,17,145,15,40,198,415
15577,18,441,11,51,195,716
30398,7,206,1,27,53,294
28891,53924,1025867,14724,7366,94650,1196531
8955,21,90,18,52,295,476
33599,86,87,27,66,534,800
8248,63,1640,37,65,938,2743
49843,0,0,0,0,57,57
10953,13,64,8,53,69,207
2328,178,1443,113,128,744,2606
48749,6,35,3,19,48,111
39861,3,105,0,12,22,142
5844,89,4036,96,143,1840,6204
40294,16,667,11,32,124,850
2316,97,691,73,225,759,1845
37485,14,42,7,25,110,198
18851,874,33555,492,329,12016,47266
905,893,122379,365,299,6090,130026
45524,1,5,0,10,17,33
48120,2,10,1,20,23,56
7904,92,772,65,165,1278,2372
18053,355,4705,266,188,4182,9696
42399,2,33,4,20,58,117
6688,36,295,19,45,433,828
41415,3,16,2,11,21,53
42487,127,447,83,69,1388,2114
3731,10126,171317,6864,11508,57666,257481
21479,84,1955,57,134,1070,3300
2254,331,1108,253,196,2624,4512
45526,2,11,1,15,16,45
50136,21,249,6,14,151,441
28549,8,37,2,44,43,134
9446,16,148,7,68,110,349
34664,13,57,5,53,54,182
21103,210,3875,92,88,2584,6849
44047,262,389,35,92,251,1029
14277,1093,10849,815,1944,4594,19295
33038,620,417,316,401,3375,5129
49528,3,73,1,2,12,91
9061,36,141,30,75,292,574
43745,49,1612,25,58,599,2343
25057,12,61,2,55,73,203
42587,1898,4099,425,478,10326,17226
1076,79,1581,32,55,886,2633
9509,61,936,23,56,676,1752
49422,1,6,3,7,15,32
33775,1859,7931,750,2889,6997,20426
43403,0,8,2,5,10,25
1154,45,655,25,41,531,1297
10304,31,130,8,50,262,481
1571,8844,115313,7561,7559,73022,212299
36384,6,85,0,17,21,129
49926,49935,230331,4386,7299,57530,349481
47635,14,393,12,13,87,519
1796,218,4345,117,81,3202,7963
3066,167,1096,87,110,680,2140
12449,886,20068,490,532,7218,29194
49127,2,54,0,3,8,67
41220,0,0,0,0,465,465
165,4491,48675,4739,4564,46415,108884
33733,2606,20480,967,1653,7436,33142
30893,19,103,7,82,128,339
37602,6,143,1,12,32,194
28405,2760,86973,1203,905,27443,119284
415,570,27938,437,469,10904,40318
33514,393,3620,226,208,1423,5870
3001,2975,33167,2615,2577,26561,67895
34299,770,40980,352,278,9798,52178
13119,545,9969,312,227,8994,20047
38058,12,112,2,39,92,257
12367,2572,19413,1731,3510,13272,40498
1838,660,17806,277,518,5080,24341
36113,8,157,1,17,35,218
12851,46,511,26,75,448,1106
38203,180,1407,77,204,1312,3180
1754,71,2140,40,78,634,2963
38206,62,100,33,51,587,833
4136,1018,7024,884,1176,5969,16071
26063,95,1114,50,61,870,2190
6,34733,385161,29036,15919,178046,642895
43647,0,12,2,4,9,27
19501,29,80,12,60,167,348
12113,2346,153521,781,606,21365,178619
46381,246,0,27,84,581,938
34974,153,971,74,104,2417,3719
899,625,105163,348,254,5369,111759
34201,12,41,2,46,71,172
16393,31,112,27,78,249,497
36884,5420,37702,3295,4279,23104,73800
18109,29,290,33,67,457,876
37037,47,486,46,50,470,1099
43579,1,11,0,8,9,29
3265,100,3488,98,113,1697,5496
17963,34,423,24,77,436,994
30243,2043,12302,943,886,4407,20581
36642,51,383,14,47,335,830
43800,0,9,1,6,9,25
32906,406,3561,192,1457,1589,7205
22649,12,80,5,55,87,239
6412,17,202,12,56,304,591
42547,3,49,4,22,41,119
34794,13,73,5,77,91,259
49901,0,64,0,3,8,75
35152,4,19,3,39,35,100
67,7670,87443,6787,7465,60925,170290
50572,33,0,6,10,136,185
38552,12,49,1,30,42,134
4853,95,1047,78,150,832,2202
14479,159,4055,71,74,1769,6128
3203,37,1180,30,70,466,1783
3138,70,2409,60,43,1093,3675
37951,15,26,7,53,79,180
31674,13,482,9,46,70,620
35778,81,1234,49,63,661,2088
8493,28,260,22,67,337,714
11979,2581,130089,1328,979,46651,181628
23043,51,2620,27,43,603,3344
49438,0,0,0,0,6465,6465
29803,57620,990278,24999,33607,193733,1300237
32248,381,328,141,171,2585,3606
38114,11,107,7,44,129,298
360,249,2338,261,328,2330,5506
50160,0,0,0,0,11363,11363
10563,17,137,12,81,160,407
10424,175,1175,96,102,572,2120
1041,192,8882,87,178,2396,11735
31376,18382,114105,11224,13495,81194,238400
18465,2291,27196,1475,1569,15769,48300
2728,23,2117,7,27,200,2374
2339,105,611,68,107,560,1451
7336,79,980,54,89,1022,2224
41374,6,71,1,13,71,162
38631,14,72,8,54,54,202
30086,20,740,8,57,104,929
6777,12,694,2,24,123,855
35828,10718,55074,4731,6106,38178,114807
36688,2395,52917,769,517,21533,78131
27963,17,52,8,46,111,234
4312,202,4612,120,106,2549,7589
7290,46,899,45,95,720,1805
325,3415,59610,2843,6141,19179,91188
14293,2643,46908,1169,862,35071,86653
19889,231,3572,228,119,2835,6985
42361,93034,319841,14797,29786,144955,602413
24577,21,164,22,108,123,438
35501,61,354,29,48,592,1084
44586,837,6580,449,159,25259,33284
32580,17,92,7,66,98,280
6903,91,443,44,88,342,1008
2624,60,726,50,96,885,1817
27521,36,89,16,98,126,365
17223,30,315,9,51,303,708
2770,77,1620,46,73,1149,2965
3345,176,918,117,157,1221,2589
35502,20,144,2,22,95,283
36718,12,165,1,24,63,265
31442,32358,266861,15612,31612,125069,471512
38821,27,50,10,49,127,263
48452,15,60,9,37,79,200
16027,76,223,46,70,619,1034
38793,23930,106735,6759,2331,40941,180696
43406,0,9,2,4,9,24
402,43,901,36,46,668,1694
16728,22,221,15,54,237,549
981,447,20438,362,267,4271,25785
8888,2973,116110,1648,1191,44397,166319
32951,34814,450685,10544,18401,91280,605724
29411,12,541,13,80,124,770
32365,1315,82006,423,457,11373,95574
39523,16620,134707,4784,15575,39223,210909
41190,16,49,18,44,291,418
34638,1839,5740,707,604,2598,11488
48895,1,1,1,0,156270,156273
2861,434,2223,204,206,1537,4604
15439,576,26328,199,311,7767,35181
12053,575,21712,336,180,10267,33070
312,94,791,58,98,860,1901
40819,628,4033,263,223,1299,6446
43614,1,8,0,12,13,34
43993,1,21,0,18,22,62
39920,4,140,0,13,23,180
30099,11,109,5,45,86,256
34367,66,718,36,76,560,1456
910,1099,9266,1201,1578,9588,22732
35920,39,118,19,68,98,342
51097,5,35,2,6,23,71
6130,331,691,325,482,2093,3922
38127,5,95,1,53,36,190
31048,27,1466,6,22,200,1721
37020,33,0,10,51,81,175
39106,13,137,10,32,178,370
22735,266,637,163,610,692,2368
1256,204,14333,142,120,2624,17423
20173,12,57,8,46,98,221
17563,28,176,20,31,302,557
5921,36,170,21,63,537,827
29767,7,170,5,25,74,281
34771,599,1611,322,1527,4971,9030
37117,31,70,23,88,214,426
38196,34,203,14,50,264,565
31073,61,712,39,78,1016,1906
32032,8773,44658,4302,8411,34839,100983
35279,8,48,3,42,44,145
27783,2940,35351,1261,4056,17540,61148
37069,6,95,3,21,29,154
47904,246,5017,44,56,991,6354
36510,8914,30623,2975,14067,26980,83559
3227,109,1541,68,77,1544,3339
4085,43,321,32,56,801,1253
30399,5,269,2,37,64,377
28841,247,4378,134,104,4020,8883
21549,17,111,9,68,155,360
37902,421,15214,260,228,7949,24072
5872,14,748,4,40,111,917
39534,44391,255305,18945,19275,119278,457194
1259,266,17148,182,156,3910,21662
1110,1059,30938,1204,1474,4843,39518
41764,3,102,3,4,15,127
7605,24,264,17,104,122,531
1744,1034,9025,1566,1731,3753,17109
42840,7,11,4,22,91,135
2305,63,1703,76,146,1065,3053
30679,706,3827,282,261,5102,10178
37010,7,99,1,22,29,158
50102,2,18,1,2,4,27
19239,13,505,7,23,69,617
2371,284,2595,194,188,1330,4591
28827,7,225,8,45,73,358
35710,13,71,2,68,76,230
14829,11641,138400,7086,9689,78883,245699
13795,19,523,3,30,119,694
37215,28,177,17,35,405,662
37856,36,599,20,76,337,1068
3550,101,814,92,166,363,1536
540,692,20439,357,263,4191,25942
29269,9,80,3,43,64,199
36991,56,961,28,39,747,1831
1203,204,3879,116,98,4348,8645
1747,824,8788,645,575,11325,22157
24775,33,18,7,66,101,225
1509,783,15608,758,1150,4549,22848
23575,13,100,6,51,89,259
7530,20,513,14,58,196,801
23499,176,833,167,102,1085,2363
48941,1636,5568,226,146,4863,12439
2096,39,504,16,47,432,1038
42601,4,81,1,11,21,118
34939,251,1440,81,106,2552,4430
42211,4,136,2,26,41,209
37662,219,1033,172,775,884,3083
20175,13,143,5,56,144,361
50438,0,0,0,0,2611,2611
25051,6,71,3,46,81,207
6270,39,275,25,50,907,1296
1116,138,2563,73,92,2871,5737
30327,10,288,2,37,69,406
481,21963,264483,19927,20946,18862,346181
48644,2325,4418,463,1822,7317,16345
6095,30,492,15,66,283,886
12623,28,2165,13,29,298,2533
15873,25,94,10,95,145,369
36705,66,95,28,61,797,1047
22687,10293,132695,5787,14611,45699,209085
35411,211,289,41,109,1006,1656
34008,247,2516,144,180,4722,7809
21737,112,3061,120,70,1823,5186
22597,13,51,6,47,68,185
44005,1,29,0,20,29,79
30107,7,69,2,47,61,186
21215,81,421,52,83,688,1325
18755,196,2730,189,220,1218,4553
1489,183,4707,131,81,1757,6859
6748,135,4406,77,75,1363,6056
11691,26,3281,8,55,405,3775
36902,8789,24515,3593,9523,29417,75837
9513,46390,288672,37254,38439,122215,532970
4421,129,3679,101,93,1411,5413
39403,2,10,3,31,23,69
7967,23,174,14,45,419,675
42055,31,131,16,30,286,494
51132,6,5,3,6,12,32
33936,26,237,2,29,80,374
42886,1,0,2,1,9078,9082
9202,748,16528,373,321,7548,25518
34895,749,1731,305,271,1196,4252
39279,9,139,1,17,80,246
36409,242,170,97,304,529,1342
673,200,8113,215,177,2691,11396
33583,19,50,6,41,136,252
22265,20634,280426,12004,11200,48510,372774
39910,2,119,0,14,19,154
33922,68,0,27,71,122,288
2910,69,1270,51,75,797,2262
48852,4,26,1,14,34,79
49645,2,55,1,2,8,68
33859,19,1591,7,37,175,1829
12347,99,1790,84,58,1240,3271
5674,194,1109,112,173,1010,2598
12781,13,101,3,71,97,285
32772,1550,1136,788,1808,2562,7844
18599,105,3923,36,71,955,5090
42400,4,51,4,25,93,177
34561,45843,183591,25226,32442,138189,425291
5205,3476,130183,1755,671,50510,186595
10532,296,8753,190,170,4311,13720
3086,722,15449,513,479,7377,24540
41623,38373,152114,6159,10099,96871,303616
34528,7,75,2,33,67,184
4124,85,2696,73,109,1416,4379
23015,11,71,11,68,89,250
13831,14,115,10,61,109,309
39099,6,75,2,18,27,128
45830,1,4,0,10,15,30
37530,13,246,1,19,128,407
38451,36,0,11,61,73,181
35475,11,165,4,43,95,318
20229,18,72,13,43,228,374
4790,29,222,8,53,345,657
8921,19,664,20,61,299,1063
43654,0,6,1,6,10,23
6178,407,70779,251,263,4438,76138
30407,14,93,9,48,78,242
1774,49,1481,51,48,782,2411
15933,571,22650,194,266,7724,31405
33176,16,118,1,40,94,269
40495,5,52,5,41,42,145
30906,9,46,4,38,39,136
1503,48,702,37,58,679,1524
34849,11,323,6,24,214,578
12611,1976,6390,1748,3632,9305,23051
3706,276,2077,179,212,998,3742
49612,0,0,0,0,3053,3053
42670,30189,5,810,761,44278,76043
49368,37,191,20,10,302,560
17351,104,4999,65,51,1410,6629
31868,11,72,3,51,148,285
48062,1,7,0,13,13,34
8959,16,95,7,42,114,274
29975,246,2081,95,201,1737,4360
24909,841,5694,611,1282,4083,12511
26321,8,29,2,49,50,138
38419,251,1904,129,113,3368,5765
20155,126,2174,89,137,1456,3982
13843,598,2493,448,352,3697,7588
15651,1664,17812,1405,1359,11598,33838
28717,22,1544,10,40,275,1891
50862,0,0,0,0,1409,1409
4156,114,11276,105,71,2137,13703
37300,11,153,5,47,63,279
1915,1870,31553,1867,1586,12969,49845
625,103,1340,75,106,1157,2781
31908,8,742,2,31,76,859
16656,739,9723,227,223,4192,15104
43598,1,21,6,30,19,77
12991,83,1143,67,79,1453,2825
35621,45,0,15,62,101,223
35459,2813,136342,985,549,32075,172764
41221,744,718,126,126,2305,4019
5555,59,282,35,72,285,733
23055,13,403,7,35,106,564
39131,2,30,1,30,32,95
2136,511,9450,283,251,2431,12926
31807,16,233,3,47,116,415
2549,238,1546,183,191,2809,4967
43227,0,23,2,6,7,38
3638,230,1368,190,250,891,2929
5369,152,5345,79,79,1793,7448
812,1083,12417,1104,1623,12195,28422
41902,1,53,1,5,16,76
21663,37,1306,17,29,250,1639
15489,1705,22878,1261,1564,6671,34079
41298,15,314,5,16,129,479
1890,158,8898,99,86,3145,12386
309,269,1767,236,370,2691,5333
9455,27,113,14,74,160,388
37975,2243,24263,1146,1233,12881,41766
2209,223,1705,147,173,1229,3477
2018,98,2440,53,54,1743,4388
22733,594,1387,420,1047,1290,4738
31452,6073,36842,3430,8566,26116,81027
36155,37,1046,10,35,257,1385
6062,45,424,19,90,402,980
32430,8,140,1,26,24,199
7307,140,676,128,170,987,2101
32792,2616,16092,1295,1528,7327,28858
13403,1133,70144,547,370,13091,85285
13441,23,839,14,40,311,1227
37659,226,1084,89,90,686,2175
1657,442,6264,459,708,6498,14371
18841,26,679,8,46,199,958
37943,4,56,4,40,35,139
7305,162,7044,97,200,1719,9222
33933,106,61,24,195,663,1049
14647,164,3291,114,129,1785,5483
35700,25,33,7,39,50,154
33916,11,57,0,41,59,168
50465,1,48,0,3,11,63
25533,10,339,4,23,42,418
8362,78,5406,41,108,617,6250
40769,82,1239,18,77,656,2072
5274,91,311,62,116,789,1369
40332,615,11159,193,283,6192,18442
2809,28,183,24,82,163,480
11635,177,2879,120,105,2802,6083
14833,27245,248074,16313,18768,111409,421809
134,7320,87796,8155,8722,61860,173853
32948,6847,42631,4039,3924,47630,105071
38619,8041,45324,3028,4730,37726,98849
2411,806,7175,433,367,2605,11386
33863,21,125,5,42,110,303
9793,630,7997,363,211,5263,14464
45689,3,11,2,21,18,55
42205,83933,13,15249,25005,87023,211223
3561,140,1074,102,172,768,2256
24851,704,2376,332,271,1579,5262
5296,70,1074,51,48,902,2145
18959,482,3890,272,237,1349,6230
40314,445,9226,168,141,11261,21241
38683,8,114,9,51,112,294
362,106,2042,100,80,1343,3671
38393,38,189,26,67,776,1096
13827,15,126,15,64,120,340
533,356,3428,461,538,2982,7765
3285,114,822,118,196,1302,2552
29493,7,87,3,33,44,174
8442,34,197,22,59,476,788
34224,4,69,3,32,42,150
7524,8,256,6,40,92,402
39363,28,421,19,44,310,822
33394,414,2076,193,1430,3462,7575
41030,60,1083,34,44,713,1934
6726,133,2101,117,145,1498,3994
50042,3,92,0,4,22,121
3082,115,904,66,113,544,1742
49276,28,12,11,25,133,209
28675,5228,160175,2046,855,59940,228244
30663,51,1201,19,58,496,1825
2744,589,7466,700,978,5796,15529
7568,657,6382,844,825,6685,15393
43798,0,7,1,6,11,25
20505,87,911,52,69,1493,2612
3436,36,302,37,111,211,697
42725,2,103,3,6,21,135
39333,26,254,23,44,330,677
15795,146,425,92,280,520,1463
17961,28,358,21,79,398,884
34893,125,1022,72,79,1702,3000
43485,2,56,2,6,14,80
21677,5470,25907,4525,11121,16628,63651
10105,48,426,25,69,480,1048
9347,447,19922,270,238,5269,26146
31317,17,67,4,46,100,234
28759,13,164,7,37,111,332
38386,78,387,26,73,650,1214
9879,12,151,3,40,95,301
32142,13,165,5,65,107,355
32338,106,2152,36,80,967,3341
48866,35,49,7,32,159,282
381,352,14449,317,221,3716,19055
30149,12,85,9,61,98,265
18087,12,166,9,46,118,351
2613,74,718,53,103,1064,2012
1049,219,6230,166,138,6242,12995
34112,12,58,6,29,71,176
1592,1026,8322,889,1130,11704,23071
40914,18,672,2,15,60,767
29375,74,0,17,82,104,277
13245,565,6910,370,204,2499,10548
32349,20,675,14,41,191,941
5629,41,437,35,42,507,1062
26331,9,40,4,44,60,157
39149,2,11,2,31,29,75
34607,2273,11956,897,1138,12075,28339
35442,11,103,1,34,50,199
9950,16,246,7,62,138,469
28771,983,51871,328,306,11537,65025
35235,220,1427,92,160,1757,3656
12689,51,523,27,37,522,1160
43248,0,12,2,6,10,30
5877,234,3412,131,1003,1055,5835
36289,47,1676,16,52,365,2156
31133,150,2674,121,131,1635,4711
37033,13358,53603,5150,3499,33852,109462
44166,0,3,0,9,13,25
2331,204,2770,189,261,1564,4988
19401,72,326,62,83,1260,1803
2189,233,1045,128,150,1023,2579
102,4027,63610,4193,5319,19016,96165
50999,0,0,0,0,436,436
40204,8,235,1,18,36,298
8908,115,3290,89,77,1987,5558
7158,32,586,30,52,458,1158
32146,15,121,11,73,157,377
9936,12938,163877,5742,11142,61137,254836
49487,335,2088,75,36,2161,4695
10908,26,304,25,69,332,756
3518,62,1557,36,42,1036,2733
17675,11,60,9,82,121,283
37799,29706,527432,11049,32306,94805,695298
5566,82,505,47,91,435,1160
20377,926,5363,397,274,2092,9052
28427,26,94,14,39,184,357
15529,15,354,8,28,77,482
21869,17,120,4,51,131,323
615,587,7252,500,570,6351,15260
37910,218,4279,102,116,2350,7065
5929,48,473,45,68,844,1478
1576,2462,12912,2715,2309,16530,36928
33206,62148,772199,25636,23614,163892,1047489
23149,16,160,10,94,143,423
9916,58,229,38,111,676,1112
5228,572,25827,256,191,6708,33554
3327,318,1162,254,169,3062,4965
8120,61,1100,44,57,1187,2449
2672,55,3196,39,107,549,3946
2521,150,906,94,158,1392,2700
248,3609,67571,2854,4728,27696,106458
51105,0,0,0,1,3905,3906
43804,0,7,1,5,10,23
682,617,7423,522,765,4609,13936
36186,129,4037,44,113,1241,5564
6831,15,762,9,46,195,1027
28835,232,1584,132,307,1576,3831
29992,38,191,21,62,187,499
16572,5,67,3,53,67,195
7106,83,252,60,102,471,968
2982,389,3323,211,206,1760,5889
48059,1,10,0,9,16,36
38691,138304,961784,40466,41294,196566,1378414
37208,15838,72648,5512,5291,85405,184694
13553,15,111,4,64,215,409
40297,5,116,3,8,23,155
1851,25,319,22,45,349,760
29966,8,135,2,28,43,216
5365,1120,61363,452,288,23682,86905
13221,2369,15300,1019,784,6095,25567
10334,221,5267,162,184,2530,8364
10793,52791,708338,36532,57327,243020,1098008
17893,12,171,13,63,112,371
37562,65,194,28,56,1108,1451
36464,17,42,8,49,87,203
13271,2165,132675,1041,643,29334,165858
32133,79,576,50,84,2049,2838
41174,19,456,6,11,119,611
24469,428,20239,184,143,3177,24171
16746,11,63,1,49,67,191
32092,9,176,2,21,37,245
28647,13,659,8,27,103,810
3002,17405,158120,11059,7489,108719,302792
2794,96,598,56,89,429,1268
45760,1,8,0,13,22,44
31880,26,1437,11,28,235,1737
4454,210,8284,138,144,3241,12017
30413,537,19077,244,212,7209,27279
48577,114,1689,30,27,1065,2925
30817,492,2482,242,284,1611,5111
45304,1,5,1,13,19,39
12569,30,290,6,40,280,646
38491,572,3212,102,190,1539,5615
25549,15,915,5,36,167,1138
10528,76,1001,35,154,615,1881
24261,570,28219,370,203,9423,38785
36350,6,95,0,16,27,144
20365,283,17958,265,307,4350,23163
30457,17,113,18,95,112,355
9008,493,2763,262,275,1480,5273
9888,303,16708,216,128,4552,21907
10346,49,459,33,98,618,1257
5168,68,3583,32,48,1315,5046
21497,202,3264,83,116,1883,5548
2366,61,171,30,75,541,878
22491,17,193,6,42,113,371
41688,679,2500,185,435,1386,5185
41218,5,26,6,20,59,116
1799,154,7160,98,71,1928,9411
29495,10,160,4,37,49,260
15069,11,57,5,59,72,204
44524,0,0,0,0,13789,13789
21485,12,72,6,54,91,235
29435,22,45,3,63,60,193
37968,70,163,36,101,330,700
8240,32,235,18,83,312,680
48804,9979,24533,1056,981,24418,60967
36865,38,203,16,49,366,672
34538,110,1369,46,70,902,2497
40046,23898,144238,9645,11589,101599,290969
40252,4,180,2,15,38,239
32301,1084,10280,667,1232,6093,19356
21177,8500,40302,6191,13030,25784,93807
265,1261,75815,457,363,11981,89877
37675,28396,581992,5886,5599,90334,712207
42714,1071,4800,318,562,6645,13396
41177,4,493,3,8,49,557
3745,68,6358,37,110,606,7179
1170,289,13532,272,142,3836,18071
396,1136,17520,822,651,10550,30679
15133,2776,27738,1187,2762,12667,47130
38600,102,397,85,100,1519,2203
15197,1842,91181,1061,598,29344,124026
508,2185,27820,4432,10583,7444,52464
32402,26,41,12,104,210,393
20847,11745,150433,6798,5161,54629,228766
2219,108,2102,71,120,1700,4101
50522,54,0,11,51,244,360
12191,2864,20268,2126,2942,7612,35812
4903,1697,16588,1387,1624,12329,33625
49980,0,0,0,0,635,635
3271,130,1758,114,193,543,2738
4802,120,757,71,117,542,1607
35868,2725,19206,1121,988,44192,68232
1672,82,1610,91,212,674,2669
5953,114,1061,95,148,1108,2526
2922,110,1930,61,132,1870,4103
2226,18,318,20,92,184,632
24029,423,7186,180,151,3483,11423
7661,3706,37683,3073,3353,15917,63732
29399,37,27,10,85,114,273
30150,16,110,11,68,125,330
39231,125,438,43,96,661,1363
40385,6,139,1,36,60,242
24985,47,249,19,85,268,668
4775,112,649,67,90,514,1432
36584,9,127,1,22,45,204
41778,3,29,5,49,74,160
20053,3368,25993,2523,7352,15285,54521
1569,2609,32278,1863,2450,19890,59090
22169,17,1582,16,46,266,1927
7739,466,32553,312,366,5203,38900
18587,13,267,10,47,152,489
1609,389,13867,404,262,3363,18285
36404,34,1188,16,40,271,1549
2708,12,74,9,76,93,264
12709,211,3230,170,102,2254,5967
23755,73027,1479538,27042,46620,155000,1781227
43628,2,70,2,6,12,92
5520,124,1048,126,165,1215,2678
32012,0,0,0,0,2160,2160
19943,14,66,12,65,145,302
3472,46,1272,25,68,618,2029
3639,96,778,47,98,526,1545
31603,15,123,3,47,85,273
5682,16322,138092,11958,10523,127255,304150
30392,5,206,3,27,75,316
9967,65,742,43,51,576,1477
6759,9,135,5,48,103,300
10581,97,4213,73,83,1629,6095
34697,13,57,1,27,58,156
39104,2,18,2,29,27,78
39918,55,167,27,44,268,561
8645,7,329,3,31,72,442
19163,15454,450601,7945,9319,63515,546834
49467,57,946,22,24,820,1869
19897,19,135,5,66,174,399
32943,29,342,16,37,238,662
41485,5,142,1,8,43,199
2404,5191,79699,5131,7864,33529,131414
63,4221,101088,3269,5932,23655,138165
34698,11,49,4,27,55,146
37870,1782,15039,641,580,10645,28687
21587,513,5409,328,275,2909,9434
2196,163,2762,67,82,2524,5598
1762,946,7692,698,840,9495,19671
43269,0,7,1,7,11,26
42654,4,67,4,28,38,141
6971,118,616,124,183,1071,2112
38789,315,4948,146,123,2833,8365
34226,6,26,4,27,36,99
38537,8,56,2,39,48,153
35250,2742,6777,1759,7084,14636,32998
1587,828,5136,850,1006,7846,15666
38644,4,182,1,19,58,264
1802,272,4134,325,337,2892,7960
33854,53,22,5,30,71,181
43791,1131,590,344,167,540,2772
49071,3,13,1,17,24,58
5424,675,4914,377,322,2241,8529
3250,265,2692,168,200,1235,4560
5876,42,360,34,50,480,966
8285,51,339,38,130,443,1001
49283,0,0,0,0,11272,11272
6518,16,355,11,58,183,623
25053,20,131,9,43,171,374
6691,312,2084,165,155,1000,3716
42209,48,199,13,46,259,565
31639,10,127,0,36,49,222
31150,130,128,57,214,142,671
31764,16863,185563,5785,7890,66791,282892
1598,212,4042,163,194,3057,7668
4508,184,3201,152,140,2827,6504
39714,2,189,2,12,28,233
12371,7,133,3,45,95,283
1491,2569,5751,2367,1377,18089,30153
3256,210,2425,167,167,1670,4639
46721,1,6,0,12,18,37
40212,837,1830,285,203,1204,4359
10825,101,2437,91,107,1593,4329
30339,11,276,4,25,52,368
31670,231,2576,129,200,1397,4533
21395,73,3629,48,99,644,4493
1857,113,1020,76,79,1549,2837
31966,188,2550,57,194,1141,4130
42853,3,80,3,7,21,114
10918,362,8116,190,116,5979,14763
4760,926,20704,562,523,7898,30613
38837,77,427,26,88,561,1179
35958,13,159,1,30,48,251
399,73,1752,56,89,1169,3139
34691,10,93,1,18,58,180
43592,0,8,1,6,12,27
24471,840,9600,583,224,4570,15817
8451,21,262,16,44,371,714
8258,13,74,9,65,138,299
35770,1017,798,635,427,3517,6394
4601,120,1287,70,119,563,2159
17831,7734,79950,4371,10124,30956,133135
46171,447,1,110,51,700,1309
34312,616,3442,338,310,1630,6336
22995,6,43,14,73,53,189
40694,2,103,1,11,16,133
50495,98,0,16,52,625,791
37285,34,402,22,83,402,943
39518,0,0,0,0,5133,5133
35274,5,32,2,38,27,104
25139,21,89,12,53,150,325
13175,83,3032,48,64,1284,4511
50410,1,0,1,0,37600,37602
41461,1,1,2,1,117517,117522
37780,32,53,16,98,616,815
29984,22,852,6,45,121,1046
2775,1493,11626,781,1061,15802,30763
43586,0,9,1,6,10,26
40636,16,79,7,39,225,366
42423,1161,27027,502,135,22377,51202
30862,44,1097,12,32,542,1727
483,1449,8600,1552,1334,15433,28368
42170,9,58,3,28,58,156
41219,360,1232,86,151,1424,3253
48488,9299,33621,1645,1618,37981,84164
29999,22,86,15,46,613,782
5005,1229,6726,1088,1204,10451,20698
39295,36,346,27,47,294,750
42550,18,10,4,38,142,212
27747,418,1590,219,210,1057,3494
43204,34,157,34,30,980,1235
41541,3,77,1,7,22,110
9794,19,322,19,55,278,693
40756,15,126,17,34,148,340
5439,115,589,64,93,426,1287
3394,105,2354,61,71,1279,3870
31016,9,34,1,43,49,136
43372,1,4,1,9,11,26
8899,28,216,28,100,282,654
28157,1140,8253,520,394,2836,13143
41619,25088,142241,6841,12680,68094,254944
30433,5,283,1,22,47,358
757,123,2703,79,90,2414,5409
8372,27,243,12,57,329,668
26043,13,61,6,56,200,336
30384,985,12053,680,787,4506,19011
28023,10,46,2,71,75,204
11339,451,15648,282,185,4601,21167
4390,27,928,9,59,182,1205
3906,78,1020,36,63,1924,3121
6827,11,527,1,42,113,694
30079,12,236,7,55,105,415
7222,484,17204,266,219,7037,25210
40398,944,1495,263,251,932,3885
40699,3,144,2,15,28,192
6829,30,701,7,53,139,930
32139,20,1258,4,29,145,1456
5116,349,19460,193,161,4807,24970
35806,1047,61938,470,265,14294,78014
30818,68,742,58,70,1755,2693
40373,2,113,3,8,19,145
31327,5387,80199,1900,751,22127,110364
42976,365,7773,105,180,3133,11556
36175,6,234,1,16,39,296
30018,8,231,12,50,66,367
35278,5,41,1,47,33,127
33132,8,33,9,69,39,158
404,1057,19111,789,1143,9761,31861
38772,10,153,1,16,42,222
2132,274,11717,225,136,4053,16405
38990,1064,7742,164,234,3377,12581
30162,6,224,1,29,36,296
1223,86,6658,57,84,1789,8674
26289,9,47,5,46,70,177
35749,5,187,1,24,46,263
31035,118,2077,185,151,1822,4353
10470,669,23764,279,276,8649,33637
2595,1008,21453,833,1117,10490,34901
35127,6,17,0,40,32,95
25035,19,45,5,48,106,223
29796,8,143,4,35,51,241
36846,6,109,3,18,34,170
37569,15606,120676,6963,9612,62357,215214
7712,449,3144,276,204,1562,5635
23869,8,37,6,36,85,172
435,2662,33254,2661,2398,18465,59440
30531,104,2588,59,161,1663,4575
4129,18,379,15,44,263,719
50348,0,0,0,0,12127,12127
5842,17,854,7,38,204,1120
39286,5,365,1,28,62,461
17835,22,105,5,60,203,395
10995,21,52,11,78,127,289
8041,42,210,49,148,374,823
34120,12,309,2,21,75,419
21563,6759,81595,3607,7683,32783,132427
35996,10,79,3,29,95,216
2049,54,1022,37,60,752,1925
42476,40,343,38,56,604,1081
23089,14,424,5,55,69,567
9941,12008,97656,9816,10277,75080,204837
41796,4,161,3,7,48,223
25283,11320,159135,3943,10487,42926,227811
17613,14,103,6,66,129,318
10448,299,16825,95,74,5867,23160
42832,114,1811,24,54,713,2716
40600,2,85,1,12,22,122
3087,1823,54164,780,344,35331,92442
3974,4410,40771,3286,2789,36514,87770
13971,33,2753,23,78,705,3592
42969,6,20,3,42,52,123
48042,0,4,0,8,12,24
39803,351,2592,164,179,709,3995
38141,637,1936,244,201,1128,4146
10409,67,374,45,77,337,900
1177,935,17387,602,666,12571,32161
17307,15,92,11,57,142,317
28843,36,1910,10,43,410,2409
32202,173,1752,66,110,2662,4763
23409,50,353,27,132,453,1015
16954,34,387,13,52,380,866
9611,2016,11930,702,387,5480,20515
37204,1286,2932,603,852,4508,10181
2031,1539,15338,1275,2057,12239,32448
22625,13,124,6,45,95,283
30065,9,191,3,31,60,294
19985,12,64,13,99,84,272
1217,119,5530,54,116,1774,7593
16568,17,116,3,62,105,303
7110,727,14739,223,415,3380,19484
8915,7005,66370,6032,6928,50984,137319
49182,2,99,2,7,23,133
528,1368,225287,318,354,4453,231780
37021,5047,34774,1473,3331,32903,77528
34724,47,77,28,42,341,535
19825,124,599,79,171,683,1656
2536,94,1407,80,136,1295,3012
21913,10,67,5,43,52,177
1028,232,5203,169,141,5523,11268
30279,4747,76431,2267,1528,26732,111705
13051,38,315,30,99,231,713
28211,1764,22048,798,764,28558,53932
23441,646,48465,226,307,8252,57896
33271,65,143,26,59,351,644
39254,2,15,3,28,34,82
10554,63,258,45,119,577,1062
43291,18,63,5,15,74,175
34798,33401,198799,14724,9857,143777,400558
4468,36,398,22,72,242,770
37822,3253,6087,385,460,3267,13452
887,72,3210,42,65,1076,4465
5622,56,1869,33,85,1008,3051
37802,20,245,5,33,141,444
8239,20,169,13,93,171,466
36387,8,106,2,20,30,166
18155,71,177,56,114,330,748
38740,237,3573,94,101,2247,6252
50184,0,0,0,0,5128,5128
10351,97,4003,70,71,1252,5493
49197,7,106,7,9,157,286
442,1951,241755,720,588,12638,257652
48316,0,0,0,0,24932,24932
43392,0,8,2,6,12,28
7645,2234,12016,2052,1575,9430,27307
36215,802,24456,266,263,4700,30487
6566,69,2849,38,36,797,3789
18489,9,212,7,75,86,389
34855,1577,50104,765,333,10729,63508
36625,357,7350,232,157,5572,13668
39272,37,67,11,41,421,577
9799,75,555,33,131,681,1475
16371,29,331,18,73,255,706
8897,19,161,16,82,185,463
12963,216,1419,168,281,1510,3594
36256,1888,6189,721,532,2498,11828
30576,13,206,2,20,67,308
470,1335,12701,872,1400,9104,25412
18919,26,40,9,65,233,373
40842,5023,14310,1764,2112,26944,50153
48030,1,4,0,12,14,31
904,699,99624,356,361,6099,107139
40700,473,3685,222,202,1020,5602
36551,12,67,10,57,58,204
41035,9,399,3,7,32,450
3328,460,32877,408,438,7249,41432
43621,1,53,2,2,7,65
43228,0,19,2,6,8,35
22279,12,43,5,64,84,208
7588,4282,28589,3018,2109,44040,82038
49757,0,0,0,0,416,416
49287,613,3916,200,286,8863,13878
27741,314,2582,270,450,2565,6181
3088,644,13585,326,234,9633,24422
2330,453,7061,415,507,3529,11965
4504,40,261,27,78,297,703
29703,512,3066,263,197,1208,5246
43995,1,23,0,18,24,66
41377,7,184,5,7,30,233
2154,2073,50831,1053,581,43459,97997
1886,301,2542,325,274,1730,5172
51050,1,40,0,1,6,48
35809,10,488,15,22,112,647
35497,18,142,12,51,188,411
25891,22,330,15,61,246,674
37454,11,28,4,28,83,154
30344,1646,20741,938,698,9328,33351
50271,41,0,11,16,228,296
10396,12962,198061,8538,11844,67661,299066
4052,486,13011,471,888,2941,17797
50803,0,0,0,0,22534,22534
39790,15380,61742,6003,8014,60300,151439
22313,39,88,14,56,309,506
6553,453,26122,210,277,6040,33102
2748,214,2893,197,342,1133,4779
3503,10902,143953,6607,13083,53402,227947
38149,220,2824,108,154,2220,5526
16636,603,13803,335,347,7506,22594
50040,2,63,1,3,12,81
1258,195,12559,144,123,2657,15678
475,128,2512,99,63,2962,5764
17919,2072,13697,1489,3425,12723,33406
40757,25,174,19,31,206,455
8862,13,130,3,41,134,321
10943,21,113,5,54,165,358
32034,77,724,38,68,832,1739
34683,0,0,0,0,4883,4883
9165,28,321,22,88,302,761
36633,16158,204876,6094,7407,75321,309856
26293,8,33,4,42,47,134
31178,2368,20235,1078,1262,12724,37667
39000,12,202,5,43,67,329
30245,17,125,2,25,93,262
42603,3509,102714,861,598,28598,136280
49697,2,37,0,4,12,55
42889,92,1649,45,37,822,2645
852,1861,4354,1241,829,10998,19283
28313,845,7026,414,380,2356,11021
35609,132,233,87,51,3920,4423
30891,3174,9016,1144,583,3519,17436
34722,10,97,4,21,37,169
3120,86,1716,44,72,1586,3504
32311,81,5831,50,83,840,6885
3879,65,337,38,102,488,1030
3094,116,805,61,97,413,1492
33457,48,904,60,145,1150,2307
14685,138,2751,114,101,1501,4605
26291,9,45,3,50,53,160
7017,1279,43622,1021,1240,10512,57674
18831,31,1198,7,31,195,1462
10519,272,14399,147,195,4843,19856
35284,75,83,23,49,697,927
863,1478,17042,1314,2181,12049,34064
537,189,11833,92,145,2060,14319
38291,62,885,54,80,1383,2464
38613,7,41,3,37,47,135
41102,10,146,4,17,85,262
32585,34,56,15,115,156,376
876,935,17044,851,975,4696,24501
7715,25,79,8,83,243,438
30013,27,181,5,52,283,548
51018,2,66,3,3,22,96
6481,37,108,27,74,322,568
22973,23,93,6,61,137,320
43267,0,7,1,7,13,28
32794,16,90,2,34,112,254
31019,22,56,6,87,120,291
38641,4,61,2,16,50,133
38039,507,2850,245,208,1285,5095
1376,312,6223,203,236,2072,9046
1113,201,1596,120,132,1190,3239
2499,251,10320,175,170,3682,14598
13233,26,435,22,46,380,909
50105,1325,1,255,85,3243,4909
5603,365,2174,189,183,1225,4136
38095,534,1892,205,149,966,3746
49733,1,0,0,0,16433,16434
12881,50,551,38,51,488,1178
34083,17,157,2,27,106,309
33880,16,187,14,50,199,466
38028,44,970,33,74,535,1656
47763,0,5,0,8,14,27
14753,31646,16528,7397,3650,38678,97899
11411,58,1018,34,46,803,1959
11266,1857,97788,907,486,22558,123596
25083,17,199,8,60,200,484
7448,25,189,28,76,162,480
24455,17824,211249,7866,12683,59647,309269
41556,3256,1594,593,998,7091,13532
24821,1087,11231,1257,676,5416,19667
9716,132,2936,134,164,2291,5657
30999,6,25,2,48,62,143
434,190,4104,88,94,2281,6757
32251,47,177,30,35,385,674
22507,2732,79777,975,643,26918,111045
42307,7707,16299,2261,8100,26639,61006
8478,20,94,16,68,164,362
50891,0,0,0,0,3484,3484
19959,20,454,15,95,131,715
36032,155,3958,98,115,1853,6179
28497,27033,390514,11600,17267,112167,558581
40361,6,152,3,26,34,221
1993,17,615,22,44,167,865
2548,270,3669,280,307,3074,7600
50110,4,128,4,7,58,201
30409,11,51,8,57,63,190
30559,8,283,4,40,77,412
8952,38,1130,10,38,322,1538
7405,28,376,15,99,150,668
2073,45,201,28,49,524,847
35537,7,151,1,27,46,232
4131,35,146,9,48,278,516
45626,7,59,5,14,33,118
41044,3,127,1,4,19,154
42996,2,95,1,6,17,121
23129,18,268,13,36,206,541
3474,30,1693,10,36,267,2036
49966,0,4,0,10,14,28
30863,13,443,5,39,76,576
16586,21,98,9,44,229,401
5914,1929,17345,1417,2132,13345,36168
20201,11,86,8,78,142,325
37914,1944,6923,222,238,10774,20101
1452,62,1320,23,46,670,2121
37386,4,105,0,22,35,166
213,167,1817,123,151,1056,3314
39412,6,32,7,34,64,143
37541,12,340,3,14,98,467
42030,473,1026,387,83,21013,22982
2693,113,1318,81,113,1583,3208
6199,69,2074,59,57,1108,3367
2590,315,3413,257,190,1775,5950
9825,15,104,4,50,108,281
3092,8236,183353,4430,8485,27973,232477
47760,0,3,0,8,13,24
6245,77,1011,54,57,715,1914
37596,313,10766,156,167,10601,22003
35332,95,462,34,216,215,1022
35740,71,3460,69,87,846,4533
10702,285,16606,125,137,3004,20157
34186,7,16,3,34,53,113
49718,97,101,31,18,547,794
33694,12,400,2,29,88,531
18231,331,2900,182,158,2275,5846
10533,37,135,22,84,232,510
43646,0,9,1,6,8,24
49869,272,897,155,48,7568,8940
48074,1,5,0,11,12,29
77,1526,42310,1149,892,14597,60474
38873,4,24,6,36,39,109
37390,7,119,3,40,57,226
30027,12,56,5,59,60,192
43612,1,14,0,10,19,44
26247,7,47,2,35,55,146
41361,608,3108,167,60,8735,12678
36599,118,865,29,29,442,1483
41802,266,410,56,119,488,1339
37172,359,4765,148,123,3399,8794
2175,844,27326,500,219,16287,45176
10372,3146,36769,2425,4062,22026,68428
9904,450,2855,274,230,1420,5229
23969,14,107,15,89,158,383
40441,5,163,3,16,23,210
2298,174,10802,139,130,3126,14371
45643,34,312,6,19,245,616
28999,50597,1048039,21185,27707,214079,1361607
22093,13,307,3,22,59,404
25457,151,3363,65,89,1475,5143
751,213,1646,198,350,1467,3874
38969,6,134,3,10,37,190
22999,15,72,5,83,136,311
48413,1,1,3,0,188939,188944
18815,21,235,14,57,193,520
12485,29,652,15,51,302,1049
30665,16,679,8,74,166,943
36847,3477,19702,983,2168,22318,48648
32995,40031,569603,16381,29333,105456,760804
29093,3909,170658,1125,690,29354,205736
43356,0,7,1,7,13,28
11741,26120,785763,9920,5696,148984,976483
15085,10487,175694,6947,22741,55719,271588
26199,6,73,2,53,57,191
34642,858,14793,328,161,8120,24260
44846,8,16,1,13,42,80
21937,16,179,8,59,86,348
37947,7,146,1,13,38,205
32094,6508,47612,2376,4067,26092,86655
6693,36,352,26,75,398,887
34985,67,100,28,75,364,634
33196,50,84,17,52,313,516
36915,1167,32566,599,306,13378,48016
8891,44,160,25,63,352,644
13201,415,11434,387,522,2417,15175
1795,105,2361,68,47,1372,3953
54,881,54400,454,542,12615,68892
3352,745,27506,661,286,11223,40421
1,146752,887701,88053,33441,407460,1563407
35668,9,112,1,20,32,174
40921,31,276,15,36,362,720
2524,279,3484,149,225,2144,6281
39529,22,290,14,53,466,845
3382,190,1297,133,142,962,2724
33024,172,3706,77,79,1697,5731
6366,31,344,15,58,341,789
39085,595,6609,340,310,2189,10043
2218,120,5401,68,178,1545,7312
40890,53,442,35,60,743,1333
578,7674,415048,3413,1522,128523,556180
27677,37,331,21,40,312,741
37358,14,72,5,39,92,222
18377,13,128,4,67,98,310
47767,0,5,0,11,11,27
1912,757,4783,673,1243,5674,13130
38198,1483,42985,634,482,21723,67307
42852,4,5,2,9,40,60
27831,13958,246540,8120,3967,84542,357127
8456,968,10389,494,392,7404,19647
9164,32,309,18,86,297,742
41729,3,77,3,6,14,103
23761,511,1472,218,253,1082,3536
48386,3,7,8,17,92,127
8155,27,236,24,66,340,693
35579,11,24,2,44,44,125
34085,71,4620,52,78,898,5719
32491,4053,63796,1532,1000,42537,112918
30284,10,54,2,45,44,155
24807,15,265,4,41,74,399
36969,9,118,7,37,72,243
3905,48,971,31,81,995,2126
47800,1,14,1,12,15,43
38932,4,141,0,9,47,201
39921,1282,25280,444,471,13370,40847
10760,18,210,21,106,129,484
43292,2,54,4,8,18,86
33493,39,330,16,42,293,720
39413,9,102,5,43,96,255
33798,92,3345,41,89,853,4420
392,60863,301563,48051,21984,148155,580616
32608,7721,19909,4201,17554,17544,66929
49275,59,242,5,22,127,455
16756,48,426,28,46,469,1017
27775,40486,498277,24525,26978,219677,809943
2702,47,631,34,108,356,1176
25027,18,111,9,52,202,392
42465,20,38,9,41,122,230
31584,9,205,7,28,90,339
21973,12,98,5,62,79,256
1474,179,4637,125,97,2175,7213
11405,30,139,27,100,174,470
9796,17,309,11,80,169,586
35075,3172,21851,1302,921,14382,41628
34534,1143,25244,492,240,11602,38721
16482,8,85,6,62,87,248
10507,2463,55905,1409,2459,6254,68490
31014,73,1436,22,70,505,2106
36377,7,123,0,22,32,184
1234,125,2457,115,120,1142,3959
7610,48,861,30,80,762,1781
7711,2943,240152,1218,412,42100,286825
1204,148,4378,67,71,3294,7958
9562,21,59,7,86,126,299
322,7333,107387,5074,5096,62101,186991
42367,2,19,1,18,34,74
43397,6,110,3,6,29,154
10756,18,125,26,114,126,409
39396,4,207,3,7,30,251
2762,389,4533,350,421,4038,9731
1460,126,2233,97,106,1284,3846
5573,60,317,40,74,280,771
33185,163,1285,99,104,5170,6821
45707,1,5,0,13,15,34
31652,572,4955,266,252,1648,7693
3845,28,224,26,88,285,651
45762,1,6,0,10,19,36
38338,3,99,2,22,59,185
41053,994,29042,445,243,10577,41301
38154,93,1769,98,165,1202,3327
1001,42,1221,42,28,467,1800
38771,10,141,1,19,46,217
14781,21,167,4,54,129,375
2573,82,822,89,126,872,1991
18323,11,69,3,46,62,191
9817,17,186,7,50,118,378
543,3167,103240,1048,620,41893,149968
37246,15,35,9,40,367,466
3014,580,24494,305,199,8590,34168
793,858,43963,561,297,14738,60417
5572,74,533,51,84,328,1070
9798,101,2415,71,79,2142,4808
6171,4666,66153,2659,2404,20276,96158
2920,136,2337,77,150,2230,4930
1211,321,10022,202,153,4509,15207
40348,32,635,19,38,260,984
35410,13,361,3,49,90,516
38875,2,22,6,41,33,104
1025,1252,8570,1053,1067,16017,27959
37906,10,106,2,25,95,238
29787,5922,66787,3475,2558,36416,115158
206,1336,12731,1293,1227,11873,28460
36148,454,1697,147,211,2114,4623
29971,9,271,6,29,56,371
31518,517,2722,291,242,1699,5471
15891,116,2960,55,75,1180,4386
31377,28,359,9,33,247,676
1617,131,1217,98,109,1895,3450
43201,4,162,1,8,25,200
30914,17,46,6,78,60,207
38123,4,97,1,53,32,187
35575,15,68,11,57,104,255
44157,0,10,0,16,10,36
26277,9,41,3,46,73,172
16041,14,115,8,49,123,309
23647,12,292,8,67,134,513
39331,3,191,1,15,32,242
27539,32,1010,21,56,351,1470
36037,2933,10664,1199,1860,20153,36809
3046,142,1220,107,115,761,2345
34758,372,2017,169,180,920,3658
34129,58,132,29,95,269,583
5848,50,909,31,60,812,1862
9782,205,6368,86,86,3257,10002
48037,0,4,0,9,12,25
36107,34,87,25,51,133,330
46728,1,6,1,16,16,40
35302,47,200,21,84,275,627
38626,42,31,23,62,177,335
6701,15,140,10,83,158,406
2876,25,307,13,56,433,834
20233,16,83,9,82,129,319
40331,141,2788,71,74,3680,6754
30394,8,213,1,31,53,306
35988,2348,9685,903,2319,10864,26119
3536,142,786,80,106,689,1803
34602,1953,5773,594,982,9903,19205
8706,57,336,41,75,479,988
3793,194,1421,135,139,835,2724
5561,76,517,43,76,261,973
31223,4987,33851,2025,6043,17116,64022
48772,7,187,5,8,35,242
34238,102,6039,54,97,1795,8087
36028,24895,145492,10517,9226,103191,293321
30727,17362,199464,7298,5561,79938,309623
5473,32,102,13,68,200,415
40690,9,321,2,22,58,412
38616,3,199,6,35,91,334
84,1190,27353,791,503,8082,37919
40786,4792,10700,1634,3451,14487,35064
39963,1487,13284,464,1117,8209,24561
4488,156,944,99,118,513,1830
23405,457,5811,346,213,5505,12332
32074,9,95,2,38,32,176
38667,81,1093,44,91,1118,2427
30714,2807,55399,1228,946,20212,80592
40644,7,22,2,12,468,511
37421,6,146,1,14,51,218
33204,1100,14026,502,312,19424,35364
43508,0,10,1,6,8,25
48750,10,35,7,19,48,119
35632,10,202,15,45,136,408
43712,6,58,1,7,28,100
35656,39,69,17,81,468,674
49755,41,1913,12,25,424,2415
36623,28,79,16,47,232,402
32622,15,146,8,42,103,314
42330,11,16,4,41,66,138
33896,8,16,3,37,45,109
32343,17,367,6,23,140,553
40062,156,1374,31,62,325,1948
6162,459,11417,160,127,5989,18152
39090,5,18,3,33,35,94
40608,4593,7252,744,2894,13313,28796
40897,751,9154,337,190,7586,18018
26105,8,35,2,48,54,147
777,69152,477792,39548,20449,189860,796801
17074,38388,391151,18368,6494,141670,596071
23709,12,73,5,30,69,189
16694,1099,63957,560,291,12168,78075
6838,13,1092,7,56,135,1303
39858,4,91,0,11,18,124
44050,67,1236,36,50,572,1961
1377,164,1621,166,129,1976,4056
48089,1,6,0,11,19,37
17483,11,99,8,42,103,263
41766,1,80,2,8,14,105
25161,1162,66861,406,323,7496,76248
6896,1394,30002,968,684,10364,43412
12957,971,3946,474,341,2510,8242
29123,27,1343,16,24,255,1665
12727,79,2123,72,72,962,3308
33018,9997,30395,4971,14427,50645,110435
50221,1,0,0,0,733,734
40828,21,602,4,17,89,733
22683,9,110,7,55,77,258
37420,5,94,1,9,45,154
2468,93,1746,47,59,1644,3589
49366,1,24,0,4,19,48
2056,50,1338,36,58,775,2257
36345,40,128,15,62,223,468
8520,15,103,10,73,85,286
42855,71,967,21,57,532,1648
6097,81,618,50,86,633,1468
34911,17,83,8,51,61,220
32854,10,459,3,21,71,564
32566,1498,31771,413,376,14271,48329
41939,10,623,3,8,32,676
47774,0,4,0,10,11,25
2147,170,6157,95,96,2573,9091
48585,0,0,2,0,88264,88266
4497,52,476,45,78,318,969
9175,17,208,9,90,138,462
3847,46,1042,21,74,582,1765
29549,10,67,4,54,63,198
41416,3,14,1,18,32,68
50735,54,477,11,7,330,879
36265,16,86,8,60,105,275
20835,90,177,57,70,767,1161
39032,9,65,8,35,97,214
32937,48129,1070478,14982,11031,125286,1269906
12343,97,1964,83,66,1280,3490
13585,3943,36912,2882,3168,28759,75664
41137,111,179,26,91,534,941
3582,166,1740,112,132,688,2838
26339,8,31,3,50,42,134
5871,21,700,10,55,125,911
23037,1786,11115,1685,5365,7828,27779
48363,0,0,0,0,3793,3793
35120,39862,673991,19467,27222,158590,919132
3995,454,2698,218,242,1459,5071
13619,132,3465,110,99,2403,6209
3434,27,780,52,207,160,1226
19283,410,1806,206,163,1040,3625
29902,19,502,2,51,85,659
35511,6,132,1,16,34,189
32291,15,348,5,27,105,500
9338,38,115,13,43,312,521
10852,20,150,9,40,178,397
23349,20,359,17,88,96,580
8293,1147,6313,550,397,2597,11004
31669,67,1135,79,86,975,2342
16664,3086,122376,1501,744,58842,186549
50418,392,0,35,168,844,1439
14835,421,10816,299,182,5214,16932
21329,2775,78748,1097,581,38593,121794
10044,25,173,10,63,212,483
30360,9,91,0,38,59,197
41092,3,420,5,9,54,491
8677,41,363,17,43,398,862
41686,42,57,15,81,181,376
43587,0,12,1,5,7,25
20223,26,102,7,74,225,434
8547,36,627,28,60,492,1243
25149,10,169,2,37,86,304
10531,144,6682,118,135,1993,9072
5330,104,972,54,80,1157,2367
2118,98,4229,66,108,959,5460
5841,25,94,10,98,174,401
2867,1007,8785,558,482,3684,14516
43467,320,4231,159,191,958,5859
51006,5,15,1,4,9,34
3379,154,899,106,121,703,1983
31003,7,48,2,50,55,162
10389,1517,40429,720,348,29456,72470
2916,66,411,44,75,460,1056
42988,4,90,3,7,19,123
36888,30,245,11,32,203,521
32927,63,777,35,49,763,1687
28805,7926,251956,2364,826,104885,367957
33248,1065,13194,605,378,45766,61008
17985,11,180,5,46,109,351
41570,24,351,5,11,105,496
49070,2,11,3,20,26,62
18589,12,156,8,49,111,336
48536,0,0,0,0,572,572
1153,470,4074,375,429,4585,9933
34236,29,103,13,64,236,445
38985,464,5897,226,228,9972,16787
25033,23,235,9,52,189,508
37945,5,54,4,40,31,134
260,1164,15454,865,1254,6995,25732
35283,28,28,10,58,85,209
609,365,10970,328,220,5180,17063
21099,16,104,8,49,197,374
5090,44,713,20,68,472,1317
49369,14,26,6,19,154,219
597,2177,189303,955,380,34479,227294
44983,1064,27626,391,200,24796,54077
41113,3,22,3,28,27,83
40488,8746,2,414,2934,10291,22387
32461,107,1940,54,50,1738,3889
45053,7,224,2,10,38,281
42320,72,25,24,72,715,908
4718,176,4483,99,121,1935,6814
43402,0,8,2,6,10,26
3101,535,2543,538,691,3983,8290
46089,37,199,15,29,249,529
18629,13,81,3,50,104,251
18743,21,111,8,39,221,400
12437,287,7925,125,98,3917,12352
3952,71,973,60,65,1106,2275
8917,5185,27911,4854,7857,23886,69693
2811,78,3368,40,79,1169,4734
50111,6,69,11,5,47,138
40934,5626,9919,2440,6272,19101,43358
49274,21,54,5,19,89,188
4361,204,3024,181,115,2465,5989
6112,1418,15776,1048,1270,10268,29780
38887,3,162,4,15,40,224
1107,1244,21367,417,296,18691,42015
34825,13017,85966,5855,10281,48852,163971
34264,8,0,5,5,378,396
30349,10,51,3,51,64,179
32800,8,169,3,20,38,238
9584,18,118,8,39,129,312
5920,50,485,26,55,599,1215
7027,20,852,9,39,187,1107
1908,148,5541,84,123,2676,8572
39324,16459,101551,6073,13546,37557,175186
4876,192,1695,112,74,3454,5527
45539,1,11,0,13,18,43
37034,228,1677,136,146,2617,4804
25345,3149,19545,1276,1023,8231,33224
40597,241,13135,71,125,2824,16396
3073,26,66,8,66,120,286
40517,61,916,23,45,659,1704
37104,165,732,84,97,1706,2784
29095,14812,268824,6159,5128,69162,364085
28701,19774,625687,6093,4126,89076,744756
37027,709,20379,353,249,15012,36702
710,2743,69164,2155,2248,30124,106434
2396,1050,5734,559,433,2865,10641
25717,15,208,18,97,438,776
45613,0,0,4,1,79092,79097
17423,29,85,11,73,249,447
1362,350,22108,138,105,3714,26415
2199,185,6257,119,106,4108,10775
47257,27506,62228,5589,9751,61060,166134
1109,160,6099,131,194,3315,9899
33737,1229,1345,251,1197,7402,11424
14575,1051,15649,382,184,6229,23495
1659,94,4056,106,90,1530,5876
1082,753,5493,659,1020,5629,13554
502,537,52283,315,294,5747,59176
16570,9,171,12,80,103,375
23641,10,56,8,86,79,239
23097,9,69,10,78,80,246
42825,3662,5617,1091,4311,13982,28663
28693,9,49,7,66,91,222
1769,209,2666,211,669,1193,4948
48867,0,0,0,0,285,285
37419,5,88,3,12,46,154
35910,9,46,4,41,42,142
1238,406,20194,308,222,5797,26927
8346,11,71,6,61,87,236
6038,63,1073,35,57,525,1753
48890,22,355,15,29,234,655
36261,14,102,9,54,83,262
327,549,7255,524,590,4483,13401
2356,389,12986,177,211,5618,19381
27463,12,138,6,55,63,274
44235,1263,6877,242,380,2004,10766
2826,116,1103,123,173,666,2181
2703,226,3038,157,271,1190,4882
23029,11,326,6,23,74,440
30646,12,273,10,63,94,452
3866,26,399,12,36,340,813
4134,944,47171,518,472,10580,59685
12671,280,38438,206,212,3980,43116
47061,3,17,1,5,16,42
33414,36,66,10,87,142,341
32697,1258,8939,599,2527,5841,19164
39023,128,0,29,76,765,998
34168,346,2813,228,209,1497,5093
19135,30,279,14,51,354,728
4415,2273,28956,1885,2622,13625,49361
29987,5,67,6,57,67,202
37896,188,408,56,76,493,1221
49969,10931,0,543,2458,13906,27838
14253,23,185,6,47,190,451
4997,127,3798,95,97,1590,5707
21711,9,184,3,34,45,275
13287,43,1408,35,46,574,2106
3036,107,780,99,160,842,1988
30116,13,85,4,59,58,219
29751,10,101,3,43,87,244
44160,0,5,0,9,10,24
16442,93,2676,64,99,1214,4146
23225,1241,48856,513,355,15473,66438
4617,72,1001,41,51,1085,2250
44225,3,54,4,13,37,111
18767,4954,42896,3868,9009,23179,83906
10821,97,2934,85,129,1853,5098
36358,8,86,2,24,27,147
562,84,1244,79,67,1160,2634
15109,5751,42771,3888,6963,34780,94153
42909,3,70,3,10,17,103
35782,8,115,2,21,28,174
33710,10,279,5,32,62,388
22189,2635,19159,1783,3383,15695,42655
2591,77,2136,46,64,1063,3386
37858,150,2285,160,130,2950,5675
10917,129,6651,124,150,1747,8801
36607,33,749,5,19,205,1011
1465,195,2913,152,215,1890,5365
29764,25,199,13,45,278,560
3380,150,941,87,101,599,1878
36159,8,421,2,18,41,490
10459,49,161,41,84,619,954
7498,26,689,12,58,159,944
1602,809,11073,578,703,7999,21162
61,5488,122659,7828,11521,28660,176156
50594,0,0,0,0,8909,8909
49701,659,1200,54,68,920,2901
496,160,2564,83,104,3074,5985
22059,12,426,2,18,94,552
33858,12,114,1,23,47,197
36511,64039,711824,19123,52032,121616,968634
577,379,3004,391,566,3484,7824
6189,90,948,56,119,1174,2387
36239,174,2406,91,128,1841,4640
10805,1140,82055,613,383,14761,98952
29842,8,75,4,61,63,211
37460,25,95,1,22,140,283
6607,48,2839,15,37,470,3409
47634,7,26,5,25,49,112
10260,808,6411,380,315,7397,15311
734,144,4821,62,124,1438,6589
45699,1,6,0,9,19,35
46701,1279,3196,275,382,9380,14512
6286,437,2665,237,259,1530,5128
32564,39,308,3,44,169,563
18653,624,4056,301,270,1513,6764
28251,36,825,24,66,631,1582
25429,7110,82917,3693,10507,30191,134418
13411,1245,73222,713,423,16113,91716
2276,337,2007,198,165,1218,3925
3433,49,294,43,99,304,789
26273,10,38,4,50,85,187
38676,47,246,25,44,479,841
18723,32,388,9,32,212,673
34048,192,3739,88,142,2661,6822
1358,308,14335,189,138,4026,18996
40576,3,79,3,15,22,122
2208,93,786,81,93,507,1560
41200,1329,2779,400,266,1447,6221
34014,13,93,5,39,107,257
37933,59,384,34,57,603,1137
29291,11,733,4,21,94,863
6947,74,616,45,183,295,1213
28983,11,138,4,60,156,369
3570,72,595,64,111,1763,2605
33877,17,206,15,48,224,510
600,331,5774,258,746,3852,10961
133,2939,82075,2256,5708,18529,111507
4804,213,2727,145,93,2156,5334
31640,17,63,9,84,76,249
31096,1094,19396,799,369,7861,29519
22445,12,193,5,44,115,369
877,40844,229117,26911,21451,208439,526762
42449,54,621,50,62,761,1548
2800,1363,15658,1555,1839,5911,26326
24181,12,906,4,45,125,1092
38063,81,292,15,44,489,921
5273,63,653,51,123,568,1458
39229,2,12,3,27,23,67
39257,48,2879,21,52,407,3407
5045,116,6722,88,82,1786,8794
4177,7325,65732,5643,4733,44784,128217
3686,111,2984,101,87,1264,4547
36644,131,235,45,65,383,859
30499,213,1771,198,148,1512,3842
589,851,12984,646,633,8636,23750
32954,881,8644,623,643,4357,15148
40142,7,56,6,62,83,214
47797,0,4,0,9,13,26
18827,14,258,6,47,154,479
17086,10,165,9,90,99,373
34759,522,6641,367,293,1823,9646
32755,6,264,2,18,54,344
49357,7362,36515,2033,1604,18009,65523
12759,15,83,2,54,88,242
13727,211,4900,148,113,3307,8679
36565,2972,16410,1011,1226,8015,29634
32065,55,711,13,31,424,1234
39037,12,75,9,27,129,252
6653,65,1276,59,70,987,2457
1897,117,611,79,124,692,1623
29423,6,59,3,49,51,168
2293,134,3609,73,72,1946,5834
40729,21335,65205,3820,2419,68341,161120
9629,46,917,36,67,721,1787
8925,24,1056,5,37,188,1310
16303,29,129,27,83,236,504
33236,8,351,5,16,81,461
16838,6,67,3,49,80,205
33446,847,6386,270,265,4720,12488
11005,1839,24236,623,770,12510,39978
40991,114,977,23,74,430,1618
37138,1,107,0,11,24,143
9519,44,209,20,56,509,838
43537,1,13,0,5,13,32
22117,549,23123,295,137,6727,30831
38201,242,6753,117,123,5146,12381
48894,3,57,1,2,12,75
42731,8,137,4,11,69,229
21833,8,256,2,39,51,356
1287,93,1441,79,82,1324,3019
10092,532,43755,327,209,7421,52244
1266,71,1312,42,62,835,2322
619,110,2546,64,56,1383,4159
34361,1071,4579,505,380,2370,8905
38367,86,741,47,49,745,1668
49523,0,0,0,0,1294,1294
7779,33,305,34,127,367,866
40958,2336,8994,778,3905,8646,24659
37854,8,198,3,36,51,296
917,487,10728,191,103,6681,18190
3099,133,498,91,121,1023,1866
7415,16,1176,14,21,196,1423
2950,311,16123,209,214,6605,23462
1182,397,5401,365,413,4406,10982
20185,19,362,11,63,153,608
34618,33009,389090,16211,19937,115601,573848
4475,52,1790,24,42,940,2848
13433,41,119,23,79,188,450
48917,0,0,0,0,1129,1129
40778,208,2587,120,48,6769,9732
13377,760,21997,368,460,4364,27949
17987,14,196,8,44,118,380
42662,1,65,1,5,14,86
32563,46,441,22,64,451,1024
2965,702,2324,728,901,4597,9252
36727,10,57,7,44,95,213
13435,12,176,13,65,118,384
2576,99,994,76,186,1028,2383
5449,32,699,25,67,418,1241
33012,9721,52116,4704,16686,35681,118908
40251,35,393,30,35,518,1011
39618,8,124,4,26,61,223
5191,85,735,46,89,378,1333
2824,30,666,21,128,221,1066
4181,33879,725350,18914,15013,263935,1057091
46102,29817,136546,6105,3732,94059,270259
12373,430,3165,209,222,1751,5777
3859,1089,3915,981,1089,10715,17789
39175,2991,95643,827,501,42594,142556
9598,812,15879,587,998,8713,26989
39334,41,857,5,36,416,1355
46695,1,6,0,10,17,34
2232,58,489,27,113,304,991
35353,30,159,6,32,125,352
10719,24819,538949,12659,18070,135148,729645
1426,847,7369,667,429,9233,18545
2071,133,4398,104,94,2759,7488
9121,101,1598,72,86,967,2824
36101,13,211,2,20,49,295
9874,10231,904,5076,1567,17069,34847
32828,21666,142843,12831,13220,82556,273116
21333,20,610,4,34,162,830
30447,11,87,4,40,73,215
29705,742,5713,373,370,2189,9387
1766,92,1350,45,56,1101,2644
37980,576,675,259,414,2022,3946
43377,0,2,2,12,11,27
32950,208,2404,83,136,3136,5967
10823,79,1731,76,95,1253,3234
5259,437,3127,210,227,2489,6490
9737,856,4571,779,1309,5817,13332
33533,18,82,5,55,112,272
50086,2,38,1,1,6,48
11761,11287,130830,7332,10821,65955,226225
30055,6,42,1,35,46,130
35817,16,62,7,52,88,225
3422,318,2821,199,214,1099,4651
10668,1389,11058,716,694,4834,18691
10728,332,1949,180,147,944,3552
35227,23,39,8,67,70,207
34710,28,540,23,55,274,920
489,2424,19892,2554,2430,28479,55779
24443,21,264,8,64,200,557
37668,45,300,16,58,302,721
3580,181,1166,118,107,676,2248
39029,19,57,9,87,129,301
15811,1059,25506,833,406,6040,33844
24489,23,96,6,38,174,337
18523,1497,42405,830,694,8548,53974
48857,0,0,0,0,3095,3095
3707,568,2902,291,226,1716,5703
33215,5,195,2,22,42,266
43669,0,12,0,6,8,26
38809,8,564,5,11,109,697
45576,85371,311666,4202,2538,110570,514347
42681,1,68,1,8,17,95
48411,72,111,72,22,2928,3205
9792,39,374,16,51,468,948
33138,381,3817,231,250,1419,6098
4712,148,4439,117,170,2156,7030
42576,1,115,2,5,26,149
43389,0,6,0,8,14,28
17729,24903,365282,11987,16971,120299,539442
5199,240,3736,202,151,3461,7790
44000,1,25,0,18,24,68
5132,319,2140,123,175,2374,5131
42488,22,497,18,30,299,866
30076,6,225,2,32,44,309
40164,6,140,1,10,33,190
1756,52,1864,43,66,647,2672
581,302,5734,173,168,2946,9323
30336,10,268,3,35,58,374
24171,536,4257,384,162,2173,7512
6945,1247,44187,540,443,15136,61553
22585,34,35,6,89,97,261
40439,5,61,4,31,35,136
6219,199,2270,106,110,3838,6523
6463,235,888,163,123,5621,7030
29888,7,165,4,30,30,236
3820,44,2178,19,38,714,2993
13505,16,84,10,67,104,281
39782,3,94,1,18,28,144
37151,59,451,32,67,765,1374
9106,31,364,25,73,316,809
37831,798,24147,414,574,9071,35004
43419,6,271,0,8,38,323
35827,746,2157,300,172,1173,4548
34718,9,31,3,38,45,126
36732,219,352,63,114,716,1464
49644,3,59,1,3,6,72
50534,1,29,0,1,4,35
1442,276,3536,221,728,2526,7287
33718,28,453,4,40,274,799
5886,25,187,22,82,199,515
2153,285,2734,266,413,2717,6415
8654,1277,3624,423,393,2021,7738
17187,1089,37922,527,312,17909,57759
43580,0,9,2,6,10,27
3267,60,189,39,63,653,1004
30961,8,53,5,56,69,191
35041,9,36,2,42,42,131
50156,472,3,168,61,714,1418
4471,47,756,30,49,667,1549
1225,291,9422,244,197,3223,13377
37265,258,1055,123,222,2807,4465
4187,63,920,32,48,893,1956
9723,316,8138,184,181,4332,13151
23213,322,2939,237,695,2330,6523
1674,499,22501,394,628,2514,26536
37815,933,2520,381,224,1443,5501
2000,950,12761,349,163,15748,29971
14661,474,2417,290,227,1417,4825
8443,34,325,18,51,376,804
16556,15,123,12,73,130,353
1112,155,4633,107,123,2122,7140
37066,8,75,1,16,25,125
15279,91,1040,37,46,941,2155
22049,28,1894,8,33,260,2223
5609,92,651,49,93,380,1265
9528,24,476,21,59,264,844
18671,22880,500197,14388,13156,97668,648289
281,377,12290,368,664,4239,17938
40995,464,1680,157,678,1992,4971
33843,12,88,0,30,54,184
36191,87,1418,53,53,649,2260
33071,1697,103216,734,341,30066,136054
10263,59,2876,39,55,750,3779
31904,12860,118507,5420,22569,46657,206013
18943,11,87,10,67,99,274
32751,36,409,13,56,217,731
48425,0,0,0,0,805,805
27579,13,52,4,52,89,210
2832,447,13208,424,261,6705,21045
1079,1013,16563,532,490,11258,29856
31205,18,69,2,58,62,209
2820,80,1009,89,155,637,1970
50123,2,33,2,1,5,43
48845,104,120,38,46,565,873
49510,23,146,10,22,163,364
41451,3,95,2,5,19,124
51064,0,0,0,0,1081,1081
17100,13,79,1,66,87,246
41124,372,2229,99,787,1199,4686
42223,649,1588,189,182,707,3315
2294,237,7272,210,198,2874,10791
5193,9,168,9,41,89,316
11093,30,326,14,50,299,719
8778,9,333,6,49,90,487
28957,3042,59073,1206,645,48185,112151
32668,2967,79793,659,638,22309,106366
33220,12,696,3,33,73,817
49867,26,0,7,23,50,106
17897,42,1243,16,43,473,1817
21185,6972,84899,4933,5471,33227,135502
3954,107,5324,111,89,2525,8156
1707,616,9950,669,1164,2516,14915
38570,5,38,3,39,48,133
29731,13,268,8,66,116,471
5109,290,1471,169,180,1166,3276
2599,36,349,21,51,442,899
13937,565,2667,289,215,1513,5249
21797,1841,59635,1231,780,16189,79676
5926,39,697,29,54,551,1370
34964,12779,87555,4353,12287,44740,161714
989,36,339,17,41,431,864
8316,20,247,14,68,267,616
49291,1,0,0,0,10890,10891
10285,18,159,5,64,133,379
48287,1,8,1,23,24,57
41316,13,266,7,15,132,433
1806,199,1685,213,282,1542,3921
10155,7905,106908,5462,11445,44477,176197
12069,715,37713,239,270,5805,44742
33025,194,3016,90,84,2649,6033
33717,14,108,10,27,146,305
25495,16,1208,7,22,165,1418
34163,18,42,9,36,64,169
17849,421,6048,223,875,1974,9541
41332,1718,11470,501,979,10369,25037
23171,308,1015,121,134,736,2314
36812,7,80,1,14,20,122
9409,51,262,38,57,483,891
41079,36,60,15,37,107,255
10822,88,2165,96,108,1552,4009
6517,11,153,13,59,185,421
46694,1,8,0,15,20,44
49457,405,6530,169,76,9355,16535
36308,794,20914,201,123,8839,30871
35603,169,3239,58,103,1478,5047
19705,9,93,4,39,66,211
38629,67,759,35,67,712,1640
45753,1405,32114,296,282,7809,41906
29419,73,2386,74,115,1053,3701
30104,9,196,2,20,42,269
6822,45,146,26,116,187,520
37196,7,141,2,17,47,214
10003,155,1986,81,85,2594,4901
1828,60,912,31,71,798,1872
12413,15458,170621,9133,8796,105483,309491
35737,0,0,0,0,9094,9094
556,123,3099,116,123,1600,5061
24355,13,112,7,42,66,240
45582,4,73,3,7,25,112
18941,84,0,18,131,172,405
36677,11,108,3,24,57,203
286,457,6208,451,593,2914,10623
37621,1172,56866,447,263,15645,74393
1887,35296,330293,35640,41692,146887,589808
42136,31,808,41,62,454,1396
4532,157,677,140,129,1922,3025
952,307,2319,334,478,3171,6609
2998,64,1244,44,64,1208,2624
26151,8,34,2,40,43,127
48341,1,10,2,16,21,50
33455,314,4218,113,99,3199,7943
37740,393,678,142,257,2228,3698
16245,19,110,9,46,138,322
28555,9,53,4,59,63,188
37777,9,256,3,26,65,359
50274,842,0,47,55,502,1446
5162,1791,44318,1446,1155,14174,62884
46711,1,9,0,14,20,44
1561,356,3431,345,656,3117,7905
6941,283,4919,149,163,1896,7410
32454,577,6762,297,770,3071,11477
4834,108,757,48,99,452,1464
42835,25,26,6,43,146,246
43303,0,20,1,7,20,48
8394,215,2443,379,423,2259,5719
36099,9,132,2,30,46,219
14921,5812,55753,4473,8932,28908,103878
37904,49,37,25,62,482,655
20995,688,3773,345,251,1577,6634
4833,109,684,50,106,453,1402
30989,39,76,21,123,279,538
50027,2,62,0,4,10,78
29583,374,15822,249,211,5399,22055
32590,20,62,4,66,76,228
35060,12,41,3,43,59,158
34868,8,62,4,28,77,179
14235,15,191,7,35,95,343
15687,2489,103374,1427,1118,21117,129525
4547,26,69,7,70,130,302
569,2351,16426,1859,1367,20832,42835
5545,80,503,50,93,376,1102
40010,76968,216258,13389,24039,70539,401193
41714,105,454,63,54,1992,2668
23917,11,240,3,21,56,331
31091,3250,36804,1265,2656,19624,63599
1015,722,55770,495,262,10798,68047
24681,12,132,4,45,121,314
3214,31,606,17,41,387,1082
34503,88,685,29,121,381,1304
35004,64,84,24,52,911,1135
2383,375,3886,313,291,3675,8540
34124,9,110,1,28,64,212
901,996,133753,390,324,6143,141606
198,5442,44224,5123,5244,43228,103261
33181,426,8766,242,154,6915,16503
36726,17151,134584,6811,10541,79653,248740
3366,4681,26651,4722,6074,34610,76738
37828,694,8526,361,209,14032,23822
164,14576,890011,4171,1722,152693,1063173
18679,101170,978328,73177,81160,277438,1511273
48343,13,30,4,33,57,137
42699,14,61,5,27,103,210
22205,28,376,2,41,120,567
285,1154,7645,1188,1389,13058,24434
48034,0,7,0,9,12,28
9733,35,3063,11,31,392,3532
7669,295,13256,202,126,4535,18414
12669,736,24431,459,282,7277,33185
44588,15,122,3,15,110,265
1519,11404,350804,6834,3292,71598,443932
10319,48,301,36,88,487,960
16059,902,6491,430,351,2306,10480
1994,185,7024,177,229,3737,11352
38033,785,2172,288,210,1338,4793
24363,7,250,5,44,62,368
34548,70,518,70,75,1735,2468
2848,295,8777,187,144,5599,15002
875,1501,33175,761,552,33807,69796
5210,304,1746,204,162,1223,3639
36976,1467,4049,758,3354,7563,17191
2379,216,1353,151,147,992,2859
31696,12,60,5,55,64,196
39966,2494,9467,967,5198,10808,28934
15,15230,87274,15399,12680,34946,165529
2981,952,31820,345,537,15209,48863
1221,1689,14075,2340,4209,7601,29914
1088,5359,39496,4004,2360,43320,94539
7477,20,545,8,43,284,900
30503,46601,1032632,19858,11972,162170,1273233
23675,14,95,20,70,229,428
42191,2,21,2,19,33,77
6165,1580,24436,1143,1337,17506,46002
17006,11,99,5,68,82,265
2906,38,358,15,47,384,842
24645,20,202,9,66,207,504
20971,1391,13043,1071,2315,7264,25084
12529,16,90,7,56,119,288
43353,485,3811,147,212,1740,6395
12561,29,868,17,59,197,1170
2223,111,995,123,204,841,2274
23637,9,72,10,77,87,255
3769,28,159,12,70,227,496
33806,129,608,85,70,941,1833
22455,13,203,7,52,108,383
43515,0,9,1,7,8,25
3525,66,3609,21,48,595,4339
49386,133,732,16,39,308,1228
976,485,9796,240,142,6277,16940
37651,1676,40202,811,642,16660,59991
36735,6,54,9,38,45,152
38481,22715,81036,5723,2974,76905,189353
17201,19,105,6,45,178,353
37984,60811,166906,7639,14334,65146,314836
21951,13,97,6,64,77,257
10057,10,139,5,64,96,314
9795,24,363,9,87,202,685
34185,5,24,2,34,44,109
34800,944,4406,527,1607,5535,13019
28815,33,455,35,62,465,1050
10079,6694,112206,3284,4708,33914,160806
25077,72,699,57,98,1284,2210
17353,43,258,23,70,603,997
29777,25,1363,10,69,263,1730
29905,12,449,4,34,89,588
35297,23,87,11,24,187,332
6399,134,10706,94,121,2447,13502
35300,1572,1,608,453,8689,11323
227,26131,466365,17663,15395,186542,712096
38195,4,17,3,32,34,90
41916,216,352,62,122,1368,2120
31608,89,3838,86,80,1093,5186
3835,91,829,73,184,952,2129
49329,976,3,346,114,587,2026
2760,77,2203,46,75,1417,3818
40877,4,116,3,9,22,154
1536,7092,97223,6854,8863,41789,161821
2131,1321,83299,928,946,13643,100137
12401,35,299,11,39,387,771
1882,140,2021,102,127,1581,3971
31238,22,245,6,55,176,504
22165,14,427,4,33,113,591
8277,9353,97162,5464,8056,45531,165566
48289,1,7,1,11,21,41
30364,1637,44770,752,631,23368,71158
37455,5,85,1,38,45,174
30967,30,736,20,38,377,1201
31498,1885,16736,854,3568,7173,30216
18045,662,26500,324,194,7258,34938
34733,376,12036,171,166,4992,17741
4792,155,20625,136,182,2027,23125
2570,86,1373,79,147,807,2492
35714,1013,14725,377,482,6371,22968
23067,281,2036,258,368,1129,4072
3782,2910,171928,1468,529,39641,216476
27363,820,3389,382,283,1736,6610
32086,1918,66294,625,621,24155,93613
9002,109,4798,105,115,2202,7329
33698,15,254,2,20,84,375
32826,76,1580,36,58,701,2451
25633,6,39,4,41,65,155
30954,157,331,65,105,950,1608
40266,576,1643,199,391,1889,4698
51,888,33999,784,1375,8950,45996
40179,49,722,33,65,414,1283
6523,35,377,34,118,139,703
31467,29,446,17,51,255,798
4213,98,1312,68,58,1129,2665
444,810,15451,626,577,7310,24774
26133,11,42,2,39,62,156
1921,380,9124,182,194,5397,15277
35032,7,60,5,47,65,184
48868,0,0,0,0,254,254
3818,20,1501,10,25,234,1790
7550,90,4145,100,139,1832,6306
5020,699,8144,447,959,5532,15781
564,543,21776,354,474,7516,30663
49968,1,5,0,10,15,31
42148,124,177,30,98,456,885
37960,74,322,32,96,1623,2147
49976,6,173,1,6,39,225
30024,9,49,2,54,53,167
33691,8,86,4,43,62,203
45536,1,10,0,9,16,36
36855,531,8072,396,376,7116,16491
15431,101,5425,70,62,1400,7058
43540,0,6,1,7,10,24
8857,1094,57583,603,310,16808,76398
3646,62,802,42,58,1226,2190
33419,804,9831,416,776,3696,15523
34626,4050,264725,1078,497,39212,309562
39831,20,500,5,18,144,687
9447,11,98,5,54,109,277
48418,0,0,0,0,40573,40573
46004,56,354,41,76,728,1255
33505,1113,4935,484,383,2422,9337
33970,2320,21948,643,294,13302,38507
39264,36,527,31,42,487,1123
1165,168,2815,127,130,1989,5229
28519,352,2442,206,201,1022,4223
5220,3396,20156,3729,5510,22418,55209
13789,25,691,5,30,232,983
41707,2,72,1,11,14,100
38375,4,138,0,10,42,194
6077,31,305,28,121,305,790
39464,14,196,8,26,172,416
495,1127,7705,1067,1237,7953,19089
13333,7886,65785,5133,5954,63766,148524
6330,217,7090,269,291,5022,12889
3826,138,1181,90,129,653,2191
888,602,13079,757,1248,4839,20525
33535,18,129,2,35,115,299
1600,182,2027,277,415,2079,4980
30654,56616,940954,27723,16361,146275,1187929
4744,5370,102330,3214,5293,26854,143061
2673,89,5944,48,119,665,6865
36157,20,1129,6,40,112,1307
36228,58,1251,33,79,645,2066
3735,61,431,31,62,700,1285
36322,7,19,3,35,38,102
34246,1050,2369,421,281,1806,5927
21573,2109,25484,1017,855,12562,42027
38486,3,279,3,16,40,341
43245,0,15,2,7,10,34
3873,50,331,46,89,448,964
28563,10,44,4,50,52,160
34414,6371,78518,3224,2935,23072,114120
2623,545,6454,268,193,12270,19730
287,6108,68627,2654,2982,21495,101866
39465,21,301,12,28,308,670
13207,27,173,13,96,147,456
3808,54,232,35,93,435,849
10755,26,285,20,71,438,840
1020,255,5542,181,231,3701,9910
4200,280,3325,200,124,2455,6384
45489,1536,18662,169,100,10989,31456
32961,2897,7442,1625,4354,11301,27619
41074,16424,7487,5397,7072,13450,49830
50073,2,59,0,3,18,82
3929,29,913,14,60,214,1230
21059,537,2360,252,211,1200,4560
35039,8,84,5,47,73,217
4575,72,418,46,78,396,1010
7473,21,82,6,56,195,360
38435,468,4814,117,161,1233,6793
1810,1977,17969,1520,2598,16336,40400
35834,3595,27555,1755,3683,16867,53455
19917,12,83,5,58,105,263
42892,11713,0,744,4432,24881,41770
19109,867,28023,532,373,9876,39671
38925,38,1,32,47,95,213
8799,28,140,21,66,281,536
50287,0,0,0,0,7218,7218
1336,207,5061,167,189,2026,7650
16784,9,61,4,39,82,195
49930,69022,18,1248,1241,47298,118827
1227,159,1093,85,126,1450,2913
41660,1000,12128,351,326,6497,20302
48439,8,494,3,7,50,562
36078,4,218,1,14,34,271
1389,347,2624,202,203,1483,4859
37965,22142,133124,9614,7524,79932,252336
31374,13922,146894,9482,14014,34783,219095
13139,532,2620,504,1004,2288,6948
1347,2457,16394,1556,1164,20563,42134
9496,24,138,8,43,251,464
50145,0,38,1,1,5,45
42295,239,0,129,150,657,1175
35159,1157,20206,378,190,13329,35260
50652,0,0,0,0,688,688
45042,12,75,6,24,75,192
39654,116,1282,48,119,781,2346
44076,0,0,0,0,307,307
23731,9,47,4,56,67,183
2039,165,691,190,161,1355,2562
3497,41,204,19,53,475,792
37747,601,3264,188,799,3495,8347
33003,9534,73112,4517,7862,48692,143717
3038,132,1842,90,122,2210,4396
49708,49,146,41,24,233,493
18443,14,114,10,49,109,296
23345,15,133,5,49,119,321
41222,13,253,1,14,66,347
21305,324,291,115,163,6513,7406
12137,232,9277,98,148,4061,13816
37189,63,580,34,63,772,1512
39541,4,56,0,19,40,119
5543,45,206,25,80,207,563
7597,63,2859,33,99,1064,4118
37179,39,113,11,44,583,790
2021,197,1586,118,136,998,3035
2863,272,2147,140,206,880,3645
6958,124,7631,100,69,1771,9695
40414,8,250,4,9,32,303
2104,18379,160283,15751,16638,88720,299771
23523,26,75,8,63,221,393
1194,860,9656,1026,1334,6295,19171
22081,285,2528,178,143,964,4098
50602,0,0,0,0,17466,17466
42791,72,437,19,44,515,1087
37647,20,72,14,47,129,282
12267,62,369,53,95,1052,1631
40157,261,1793,79,134,1723,3990
3275,27,314,21,69,328,759
30913,294,6049,154,178,2613,9288
7639,21,97,14,61,157,350
12997,1437,9594,668,532,3801,16032
2954,90,4833,120,111,1627,6781
30321,2454,63174,880,548,17838,84894
46808,0,0,0,0,182,182
35047,27,63,6,36,145,277
11533,29,147,19,73,234,502
1894,460,62960,210,242,4149,68021
27621,37,239,33,81,385,775
37521,104804,627207,30987,16574,256975,1036547
33002,19,75,11,93,104,302
2008,60,917,40,62,914,1993
4923,89,745,57,105,939,1935
1967,200,7663,155,161,3205,11384
23133,4646,19160,3634,7050,19643,54133
3053,141,7258,112,277,742,8530
31894,67,1094,34,68,766,2029
28531,183,3123,117,158,1282,4863
42290,140,661,33,63,535,1432
16742,32348,359550,23961,42987,122071,580917
24675,29,352,14,76,255,726
37859,128,2173,158,134,2852,5445
37604,6,124,1,11,36,178
35198,1437,37112,777,476,27651,67453
37279,17,152,7,47,94,317
40907,10597,48767,1730,1182,48006,110282
2274,124,14123,77,69,2212,16605
16169,1117,15891,732,1814,8736,28290
6063,10,65,5,47,105,232
38700,11,215,1,15,59,301
30059,9,268,5,43,62,387
27899,47646,1356566,17345,37285,85075,1543917
42264,4,12,1,16,32,65
12767,28,151,30,107,164,480
2837,55,655,47,64,587,1408
159,830,7022,766,1250,7614,17482
49445,9,23,7,21,55,115
6076,64,1274,39,60,914,2351
38994,440,1327,204,176,962,3109
33840,1254,5937,789,2561,7819,18360
6973,3040,12744,2746,3647,20167,42344
33080,4461,51530,1943,2034,14612,74580
29713,7,58,9,50,112,236
1514,171,4338,146,134,1936,6725
2158,2425,20061,2308,1992,30328,57114
31636,30689,201694,19075,41769,105831,399058
2725,195,6279,114,107,2197,8892
17249,712,5740,451,653,3977,11533
29389,16,42,9,52,53,172
4416,132,1279,111,135,1707,3364
2243,138,469,93,162,1331,2193
31942,7,151,1,39,31,229
11713,9,43,4,51,80,187
39640,531,3059,274,180,1353,5397
42656,1,62,1,5,14,83
35050,6,48,3,50,34,141
770,1020,41806,487,206,21661,65180
21667,807,44672,402,182,12131,58194
9032,345,22423,119,159,2333,25379
35574,14,55,3,44,61,177
34888,120,859,52,373,369,1773
40830,1,120,1,6,19,147
21959,14,111,7,63,76,271
21771,297,9402,109,159,2794,12761
7647,17954,167779,16020,17770,103395,322918
18085,17,279,4,45,139,484
31530,179,2198,163,136,3288,5964
50031,2,77,0,3,13,95
2229,1165,12382,920,990,5836,21293
29633,9,342,7,40,97,495
146,2130,35164,2046,2511,15192,57043
11111,48192,1097827,27757,35358,250791,1459925
35003,10,136,4,44,43,237
21435,1959,14982,1345,951,9930,29167
7681,23,128,10,58,251,470
3243,16,88,6,64,95,269
1477,172,4028,120,93,2675,7088
40646,754,24374,174,147,13441,38890
13709,1029,44537,437,474,12243,58720
34028,1018,4246,580,2658,4614,13116
38620,1862,1723,708,391,1921,6605
39117,15,75,8,36,157,291
35180,22831,193413,8983,4235,110496,339958
1210,34452,338388,26618,17826,213639,630923
19521,33,2162,13,31,300,2539
37646,163,1950,75,185,809,3182
5986,17,110,8,52,174,361
7582,374,1582,204,184,1187,3531
6839,17,589,5,43,114,768
32494,12058,70257,5726,12697,28394,129132
3813,35,234,18,43,409,739
10633,18,90,11,67,99,285
33658,128,1818,115,106,1821,3988
23617,12,106,7,65,94,284
20159,3211,187831,1578,1125,12949,206694
3734,80,953,66,82,1014,2195
29974,5706,97249,2626,7003,19997,132581
2089,301,1365,273,220,3108,5267
31071,27,131,15,79,214,466
37135,3,111,0,8,22,144
45661,1,6,0,10,20,37
34856,5,237,2,19,35,298
48561,3619,3117,1667,116,286099,294618
7461,18,225,9,47,150,449
49877,3,3,0,0,69890,69896
29073,14,186,3,45,64,312
23915,36,367,21,78,204,706
22421,9,73,7,38,80,207
48824,403,1,106,38,1115,1663
1327,726,7126,649,731,3627,12859
50280,51,23,9,25,201,309
50326,5,6,1,7,49,68
3377,126,922,81,105,593,1827
40582,3,73,2,14,29,121
39086,2,289,1,28,52,372
42458,2,26,3,33,47,111
30127,4859,66838,1933,2959,29269,105858
38824,190,5765,53,52,1865,7925
16512,9237,92206,7078,13246,36145,157912
9334,15,66,6,47,216,350
18269,10,44,1,51,54,160
38407,6,140,2,27,54,229
42372,3,53,4,26,44,130
1448,542,6366,672,947,2599,11126
36686,1234,1,618,164,4431,6448
6823,32,905,10,57,170,1174
33907,11,263,3,20,40,337
48328,1,8,1,14,16,40
12711,4846,75077,3161,4238,17511,104833
17957,14,174,8,44,123,363
19581,451,9378,191,209,5403,15632
2840,35,1106,33,72,622,1868
49848,221,1079,82,84,1699,3165
44399,3,11,2,11,21,48
49682,3,92,1,2,17,115
41091,4,406,7,9,60,486
5922,49,169,18,49,452,737
4943,60,737,45,70,1037,1949
39592,879,9091,360,290,5299,15919
12695,844,35043,270,317,8563,45037
38211,59,379,37,75,627,1177
28559,7,35,2,45,38,127
37408,130,1504,50,111,1171,2966
41075,36,612,62,67,430,1207
6344,304,8302,195,115,5457,14373
5526,159,29960,114,163,1996,32392
11073,123,8274,93,172,1740,10402
1040,293,1116,245,285,2056,3995
30753,16,106,7,74,121,324
1027,58,1149,45,74,699,2025
19945,170,4200,135,215,3094,7814
38963,614,11126,355,231,9095,21421
41667,12,61,5,32,46,156
31252,20,905,11,22,186,1144
31137,109,1241,52,79,1199,2680
236,683,8511,856,1085,4302,15437
8935,17,1103,9,37,275,1441
38044,1,165,0,13,30,209
22255,16,669,5,39,115,844
2386,365,32628,265,258,5260,38776
6091,30,138,16,46,260,490
16802,34,480,17,57,561,1149
32297,21,343,6,23,75,468
43998,1,22,1,19,21,64
6384,28,199,15,41,198,481
39114,32,3552,12,28,303,3927
5475,46,251,32,112,380,821
2985,3249,31252,3152,3406,21980,63039
39040,47,55,13,137,213,465
16748,11,87,5,56,108,267
47913,2,49,2,5,11,69
3288,372,5497,400,263,3465,9997
7468,474,7990,268,323,4200,13255
5687,84,363,38,92,338,915
34936,22,200,1,22,127,372
38398,3,64,2,28,39,136
32237,14,85,9,49,54,211
43001,152,1796,57,135,728,2868
2838,106,591,58,98,450,1303
38796,4,168,1,12,36,221
38622,7,113,3,44,44,211
4798,286,9536,185,168,4097,14272
32673,7680,57751,3827,4640,42514,116412
486,14668,98186,9811,5801,137846,266312
37894,83,737,35,49,485,1389
34969,12,462,6,28,85,593
15377,4620,55277,2797,3611,24525,90830
4650,168,3783,69,89,2132,6241
40909,157,1253,23,71,259,1763
40194,84,765,18,17,461,1345
7870,858,33937,798,485,10434,46512
35231,114,1532,57,80,2730,4513
36250,339,6822,187,224,6585,14157
47946,0,5,0,9,11,25
38194,4,40,4,48,61,157
9284,32,158,28,117,297,632
34188,7,18,1,40,34,100
5386,177,2070,84,124,3536,5991
15291,164,6176,51,129,1168,7688
16604,21,2717,5,44,219,3006
33726,3613,13802,1600,2802,15141,36958
33247,170,1931,69,71,1839,4080
463,659,58425,441,302,7972,67799
26345,6,37,3,48,52,146
9244,22,316,16,57,214,625
35349,64,0,30,51,154,299
9308,1135,18302,613,522,3943,24515
12295,20,747,12,59,233,1071
9526,55,362,41,79,735,1272
1392,67,1432,38,74,704,2315
36246,360,1444,137,178,2264,4383
40233,589,1540,159,231,2493,5012
44274,2765,5717,632,2363,9744,21221
5916,11,78,9,40,150,288
1907,60,899,50,75,915,1999
40849,665,14925,216,447,5127,21380
10687,304,20075,141,210,4425,25155
31,2540,179393,1320,1155,39550,223958
4484,72,513,35,61,940,1621
48177,46,713,9,34,369,1171
8786,33,216,27,118,186,580
24175,2130,18507,965,863,9750,32215
39706,3,159,3,12,32,209
16261,24,145,7,45,227,448
12589,31,299,15,99,247,691
32593,14,110,8,59,125,316
50552,0,0,0,0,5604,5604
38478,1,110,2,13,41,167
23931,86,906,49,96,1127,2264
48810,97,0,22,32,437,588
31436,13,58,3,48,70,192
644,380,21183,421,264,7092,29340
32239,815,4876,364,342,1702,8099
44376,287,0,61,37,583,968
2884,166,5625,116,219,3172,9298
24713,105,6094,76,77,1256,7608
15225,18500,282284,10525,13578,88444,413331
36946,4369,267564,581,496,27609,300619
37074,7,126,3,29,36,201
22145,11915,263144,5980,4853,67288,353180
48039,0,4,0,11,12,27
6462,38,1023,19,71,446,1597
34491,385,4511,237,246,1136,6515
3221,278,16598,287,238,6187,23588
41375,548,836,182,125,552,2243
28047,12,379,8,46,112,557
40340,51,520,20,45,526,1162
23177,24,261,18,38,279,620
39678,104,229,35,90,778,1236
4896,11662,98906,9263,11807,70064,201702
2343,169,1830,93,153,1161,3406
2416,128,1229,58,125,626,2166
31593,572,4108,353,281,5750,11064
16211,554,4460,534,1773,3104,10425
37553,8,280,2,20,42,352
38180,136,1034,74,86,1449,2779
2555,179,1688,135,185,1559,3746
40112,15,258,3,20,96,392
31997,161,4571,99,98,2644,7573
38305,3,98,1,13,23,138
40159,7,157,1,17,44,226
39371,6,45,6,33,53,143
49734,58,177,34,20,152,441
37655,831,17488,382,825,4842,24368
1382,274,4792,187,215,3265,8733
29261,983,8454,556,409,2657,13059
39583,4525,18389,1819,3880,21628,50241
2646,30,1031,28,71,339,1499
8333,17,768,9,42,204,1040
44388,0,0,0,0,5649,5649
15211,52,89,23,66,304,534
2534,185,2841,137,238,2209,5610
37102,7,85,7,62,49,210
24919,691,14846,353,228,8406,24524
30019,7,225,10,50,62,354
30250,708,13733,272,176,7019,21908
43428,3,6,3,15,25,52
34292,74,197,35,132,417,855
22419,263,3282,184,319,3734,7782
50613,0,0,0,0,1625,1625
11079,6605,52523,5494,9512,34116,108250
41512,428,2151,193,174,1019,3965
10732,65,1742,63,62,1102,3034
33352,112347,894602,49086,43681,344036,1443752
33473,25,121,7,93,219,465
47912,1,58,1,3,10,73
1324,296,4833,260,370,3973,9732
10055,56,1142,46,69,923,2236
16726,101,1498,74,169,466,2308
4690,409,3599,519,520,3629,8676
4948,53,857,23,72,573,1578
38408,132649,1065276,26514,20990,149958,1395387
35031,7,42,2,41,65,157
47765,0,5,0,8,14,27
49376,0,0,0,0,590,590
50325,1560,18259,241,74,10295,30429
13153,15,955,7,23,118,1118
36868,14,192,3,30,69,308
1312,448,3153,449,504,3917,8471
50515,186,1,29,10,350,576
31534,60,1251,26,149,174,1660
25639,11,273,3,25,67,379
35147,5,29,1,43,40,118
4786,236,8008,196,193,3006,11639
31015,7,26,2,41,39,115
30083,7,143,1,37,31,219
41379,2126,8045,673,522,32979,44345
14247,32,735,15,46,340,1168
7330,37,1194,31,70,646,1978
4817,71,452,52,96,445,1116
14075,31702,296241,22332,21261,173068,544604
43382,0,3,0,8,14,25
36921,30,1321,16,50,281,1698
2961,797,98062,301,353,5135,104648
2885,82,426,78,145,600,1331
41054,5,52,8,24,63,152
22479,11,189,8,43,118,369
4566,61,1144,56,62,819,2142
24995,12,198,2,25,46,283
19989,17,90,13,93,158,371
12585,151,4064,75,130,1308,5728
30573,128,2355,77,84,1544,4188
20581,18,249,17,56,127,467
43259,1,10,2,8,8,29
10628,284,5193,191,138,3335,9141
35326,49,576,36,45,676,1382
9045,28,749,15,43,336,1171
11227,3641,28130,2518,3766,27897,65952
1644,76,980,44,62,809,1971
17787,39,1057,18,40,602,1756
35400,18,269,5,30,119,441
13551,32,115,26,63,327,563
13463,45,50,14,85,132,326
7518,9,1151,6,44,178,1388
9587,4166,48732,2355,6061,21727,83041
6116,440,621,402,414,954,2831
10165,76969,336914,57676,29264,264969,765792
30732,13,144,10,70,146,383
2312,67,1660,45,65,1017,2854
37398,66,455,29,70,704,1324
9287,384,2006,199,208,1306,4103
30393,9,218,1,23,58,309
49938,0,0,0,0,2241,2241
1066,495,25564,545,430,6619,33653
21971,12,107,3,64,75,261
12967,9234,117915,7201,16671,39060,190081
26143,6,51,2,59,69,187
30269,427,2097,231,205,1033,3993
692,153,915,102,138,764,2072
39906,17,50,8,43,99,217
2307,135,1506,94,82,1201,3018
2354,468,18139,202,163,6794,25766
32629,10,50,5,75,82,222
46316,1,8,0,10,20,39
17825,27,155,25,85,175,467
6902,137,360,91,141,1555,2284
24903,7,238,3,36,44,328
30307,31226,483980,14548,31747,92140,653641
596,366,37460,311,248,6267,44652
19279,25,642,9,38,218,932
311,562,3304,488,475,6137,10966
47143,1,11,0,10,16,38
15451,22638,710028,8775,11270,54077,806788
6654,66,6667,36,72,585,7426
6318,105,969,71,154,639,1938
37749,17,87,5,60,88,257
44154,0,12,0,15,10,37
2024,66,181,56,131,268,702
3517,16,155,7,49,120,347
31769,10,263,4,24,101,402
42744,1,65,1,7,14,88
46277,1,5,0,11,18,35
31478,79909,691415,36592,33262,253575,1094753
4393,29,1412,16,52,201,1710
3605,53,517,27,51,637,1285
5544,78,574,43,109,430,1234
5427,476,2701,264,198,1585,5224
2498,226,10380,170,156,3539,14471
32834,9,59,7,56,68,199
45997,8,16,5,19,96,144
5478,17,149,12,85,153,416
40659,158,1334,69,80,1608,3249
21081,24,464,12,49,168,717
41498,5,111,4,6,22,148
22831,652,3519,581,2000,1870,8622
39721,116,2372,102,119,1583,4292
28057,9,309,5,42,73,438
16091,367,1753,194,190,1168,3672
1274,209,1689,143,122,1101,3264
37273,7,187,3,12,46,255
24663,22,141,14,75,248,500
43678,0,5,0,7,11,23
16804,22,108,2,64,129,325
43518,0,7,0,7,11,25
31645,1019,35017,349,334,13339,50058
48842,0,0,3,1,14136,14140
30048,8,49,5,55,61,178
6484,38,1024,20,43,434,1559
48077,1,5,0,12,16,34
39996,5,229,1,16,33,284
11505,52,464,29,30,433,1008
30974,9,28,3,50,47,137
993,96,3897,76,71,899,5039
31926,23,170,8,21,196,418
45706,1,5,0,11,19,36
40337,579,6743,323,315,2133,10093
14059,50,752,45,63,731,1641
29513,558,12802,213,130,6996,20699
15021,46,2036,19,51,622,2774
33788,1248,6033,675,1504,5762,15222
6930,56,4428,38,110,516,5148
39405,2,12,3,27,33,77
3452,242,1465,153,186,907,2953
1119,694,132003,289,344,4114,137444
8206,725,3937,679,1212,2970,9523
646,142,1905,182,244,1523,3996
39027,13,209,3,45,83,353
44040,185,1223,69,451,450,2378
1316,542,10800,305,596,2268,14511
4459,477,0,183,439,497,1596
2472,2754,236868,815,628,17426,258491
11595,144,1989,179,407,311,3030
48128,2,18,1,19,31,71
43488,2,18,2,7,18,47
1459,780,6164,734,598,6278,14554
30120,12,47,5,63,65,192
36851,7,83,2,23,46,161
34622,43,350,14,35,415,857
35390,15,308,5,39,57,424
11751,6012,49732,3447,5303,41428,105922
32262,22481,199367,8825,21731,66830,319234
17010,21,1524,9,33,243,1830
15711,427,7489,356,336,7316,15924
11049,20,224,5,54,186,489
29527,15,66,9,67,145,302
9341,79,308,33,74,307,801
3444,154,886,105,212,1274,2631
1483,1394,5025,1055,703,14386,22563
38056,56,235,43,75,945,1354
33527,16,167,2,31,63,279
9947,84,136,34,228,198,680
616,222,893,227,259,1989,3590
30213,7,197,3,34,76,317
8963,30,595,18,66,371,1080
34337,511,4066,232,814,2477,8100
8123,107,368,85,136,936,1632
33339,325,328,154,187,1378,2372
606,713,5961,579,534,6921,14708
9393,183,2080,167,153,1641,4224
20919,467,18204,196,313,4295,23475
20755,13,89,10,77,168,357
13391,2645,53365,936,875,32691,90512
36245,4837,34665,1935,8952,21675,72064
3232,53,964,48,48,560,1673
3778,37,395,23,54,390,899
41103,25757,92807,4379,10995,52967,186905
15863,3996,26585,2519,4308,14592,52000
30923,45,500,31,50,637,1263
3821,37,1882,23,39,737,2718
44096,35,29,9,28,204,305
22415,10,518,4,36,88,656
29895,12,213,1,49,82,357
32856,8,245,2,24,45,324
36742,109,477,62,78,569,1295
39499,1,124,1,13,19,158
1914,2224,21352,2108,1200,10710,37594
41381,254,187,123,268,1022,1854
24259,25,184,11,42,172,434
33709,148,1383,68,97,1507,3203
6645,2081,25554,1787,4678,11200,45300
29898,12,151,5,33,69,270
4867,110,662,56,107,417,1352
34633,13,310,2,21,71,417
2157,322,2816,257,284,2316,5995
40852,96225,484203,14354,7112,169983,771877
40708,17408,92282,4244,14275,39596,167805
16189,754,6003,429,345,2288,9819
9290,60,899,47,80,1060,2146
2327,202,1586,113,150,826,2877
7052,35,126,12,64,427,664
8733,10,263,2,29,76,380
694,1121,14119,1003,1209,8077,25529
48369,108,386,11,49,166,720
45040,21,35,8,29,99,192
1075,51,1078,27,51,583,1790
837,955,18063,665,649,8809,29141
35338,2500,82695,784,501,19669,106149
9875,764,2846,337,268,10111,14326
39030,15379,96937,4607,14284,36476,167683
20243,13,146,7,65,118,349
17487,24,55,11,57,124,271
43704,5,87,2,6,26,126
40906,27876,0,4536,6105,18193,56710
10060,13,138,5,66,94,316
1155,96,818,78,89,910,1991
7612,447,2961,256,250,1343,5257
7527,15,90,9,92,122,328
5098,24,417,16,79,343,879
736,311,11269,102,269,2259,14210
2974,72,1207,31,62,842,2214
275,765,12241,579,946,6088,20619
17293,36,889,14,33,284,1256
34465,3771,34288,1870,720,22738,63387
5962,1900,66467,1332,2620,4331,76650
11307,31,585,26,77,258,977
38084,24143,117862,8529,7198,66415,224147
39326,18918,156602,5793,12431,66537,260281
33122,20,201,5,54,128,408
38070,7,159,5,48,52,271
5643,319,2389,187,203,1560,4658
36531,452,438,200,398,1682,3170
32820,13,113,6,83,50,265
12659,17,1687,7,25,157,1893
7430,71,2032,64,78,1193,3438
43448,0,2,0,7,17,26
690,1985,13025,2164,2084,16020,35278
5252,678,36013,363,260,7788,45102
2516,217,2286,159,203,2400,5265
2747,574,3988,901,1396,3909,10768
17619,21,97,15,64,219,416
34117,14,384,3,28,90,519
10901,20,275,22,60,333,710
6842,10,531,2,42,93,678
33783,879,40950,355,484,12942,55610
4898,64271,670447,46665,56255,203858,1041496
39644,6,115,3,12,53,189
9944,102,213,102,102,649,1168
3801,72,2423,46,93,1129,3763
8064,82,1174,29,70,1097,2452
7363,101,2109,51,82,1194,3537
155,551,24081,353,389,8547,33921
27503,708,4710,509,2009,2878,10814
17473,9,95,5,46,93,248
12031,10532,66750,5212,7857,76807,167158
40911,28631,141637,7605,6338,115251,299462
5223,23,443,16,90,115,687
30313,20,136,9,61,167,393
40656,226,3286,161,75,2707,6455
11359,496,36166,269,296,5065,42292
9007,15,160,10,70,110,365
990,1503,28127,1332,1688,12852,45502
45820,2,6,0,12,19,39
46119,74,221,47,51,575,968
25861,208,12064,103,76,2094,14545
48023,1,14,3,7,17,42
30803,20,139,11,81,191,442
43767,4336,7639,1034,3232,22238,38479
36129,8,81,2,18,23,132
8716,10,305,8,66,109,498
38797,1730,18312,418,1046,6475,27981
10796,168,2693,132,117,1073,4183
1486,4516,26437,5424,3943,17893,58213
36759,9,42,6,37,47,141
42048,2445,1583,655,367,1968,7018
257,6762,83370,4845,9171,40093,144241
33267,79,8,16,61,342,506
22997,25,116,14,78,143,376
16239,699,36128,364,261,6649,44101
27681,20,78,5,58,119,280
92,1746,17526,1835,1073,9629,31809
34036,1089,18628,403,488,5665,26273
38397,20221,178249,5923,13995,62786,281174
9041,18806,442540,8635,17354,89234,576569
3176,93,248,58,97,1087,1583
9310,632,3491,333,290,2010,6756
22393,10,158,4,31,71,274
32623,8,98,3,42,57,208
1566,1687,60318,960,406,28500,91871
48334,2,15,2,15,19,53
40350,5,147,3,14,66,235
8574,44,404,34,111,244,837
39917,1110,0,82,1213,1814,4219
32933,12,205,6,48,70,341
42078,5,1062,3,7,64,1141
35095,8,45,4,39,58,154
36233,9,65,1,24,42,141
723,76,2364,65,85,1026,3616
34280,31149,395880,12263,25191,102627,567110
38301,2545,10058,1172,3640,12403,29818
22543,915,5846,471,385,2236,9853
32238,652,2594,290,274,1079,4889
49945,357,1899,126,100,804,3286
34599,64636,693620,25978,15710,293485,1093429
32475,8,59,4,47,34,152
17689,34,352,19,50,508,963
31804,5426,32567,3316,8433,20307,70049
20499,23,86,11,48,209,377
50621,6,25,2,7,18,58
34286,8,127,1,29,77,242
3624,53,1703,57,104,418,2335
34757,34,206,10,24,320,594
1745,45,304,38,84,455,926
1220,240,6226,139,129,4462,11196
19879,21,247,16,74,383,741
43241,0,8,0,9,11,28
4793,207,35787,142,183,2171,38490
32982,371,3024,235,208,958,4796
40217,329,764,116,107,353,1669
42649,2,102,2,6,17,129
25971,12,296,8,41,137,494
44387,6171,9592,966,3388,14365,34482
23697,311,7503,227,219,3176,11436
8730,9,378,5,33,80,505
40255,3,144,5,9,25,186
1230,1031,12329,1132,1177,9787,25456
296,1359,11316,1640,1945,5418,21678
1888,417,17446,297,186,4443,22789
5160,61,485,42,87,337,1012
6657,110,2688,84,70,1457,4409
50432,0,0,0,0,87,87
49987,789,1,285,87,557,1719
35519,17,89,13,53,172,344
7697,32,228,13,37,278,588
14027,1348,87797,705,439,16124,106413
40471,1177,1205,360,242,1033,4017
37018,11,93,1,24,50,179
4375,109,1513,129,291,454,2496
5605,89,664,68,95,468,1384
35298,5715,23791,2381,6672,18513,57072
35370,494,7974,212,245,3481,12406
18799,36,2181,26,61,625,2929
2303,93,2167,93,144,1099,3596
25059,17,67,6,56,56,202
37036,915,3975,461,963,4732,11046
11537,27,586,10,51,238,912
14537,20,259,9,44,185,517
1590,172,1055,142,234,1103,2706
50667,258,0,12,18,294,582
329,12632,77243,9740,6705,114881,221201
42911,3,54,1,3,11,72
35472,121,1709,80,85,1401,3396
5131,45,296,44,90,356,831
13817,23,119,14,69,223,448
38426,243,3666,126,137,2878,7050
42256,3,81,1,10,45,140
16910,2070,21662,1147,1936,11939,38754
5250,113,768,93,152,1101,2227
35651,29,264,7,37,151,488
23727,9,38,4,38,61,150
5065,241,17981,143,189,4096,22650
36825,100,1931,73,119,1084,3307
2326,123,858,81,98,636,1796
18315,14,59,4,46,69,192
39415,73,586,26,62,438,1185
7816,32,615,25,54,484,1210
40097,494,782,175,135,1972,3558
1243,1715,10494,1908,2428,12564,29109
2393,78,6907,49,112,615,7761
6942,24,205,18,49,318,614
14539,1201,6751,576,420,2930,11878
50815,3,175,2,2,24,206
19351,130,2189,55,104,759,3237
12935,26,1896,22,31,289,2264
23519,337,2685,207,208,856,4293
50006,3,96,0,2,13,114
37152,61,139,13,40,184,437
6163,598,25621,379,433,9643,36674
11825,45,383,31,87,248,794
45531,1,9,1,14,16,41
31168,120,5663,89,127,1220,7219
50080,0,55,0,3,12,70
27943,87,125,35,96,771,1114
40917,3,104,2,8,16,133
37242,42,196,12,34,417,701
37695,12,144,0,22,34,212
9880,22,235,15,48,227,547
3051,91,3146,72,116,1410,4835
2989,439,3013,229,237,1552,5470
34612,33358,383081,10400,5526,80579,512944
45444,20,44,8,18,80,170
34190,9,79,10,66,65,229
3011,324,6839,200,221,3470,11054
4713,664,14942,367,536,13226,29735
19751,15,101,4,58,113,291
1036,101,2953,79,114,1569,4816
40431,49,285,29,47,667,1077
5056,72,2097,57,48,1044,3318
30935,6,39,2,41,41,129
15993,33,799,19,69,418,1338
31760,17,455,1,26,91,590
27589,15,208,12,79,138,452
9925,559,41053,364,218,8000,50194
12187,632,35523,380,191,7392,44118
32803,9,303,3,25,100,440
20767,12691,244386,3980,1188,33774,296019
1057,257,3124,148,253,2261,6043
32483,4950,28308,3338,6331,16729,59656
2890,4424,414098,1493,712,46122,466849
8408,3108,128119,1890,837,25156,159110
45660,1,6,0,10,20,37
29557,11,243,7,46,86,393
38234,2240,100414,560,328,21620,125162
30485,7503,47540,3889,8433,53618,120983
9403,27,215,18,64,295,619
21027,121,1288,74,72,2603,4158
39875,55,1735,20,45,482,2337
975,1117,15003,501,284,15514,32419
9759,22,219,14,46,262,563
17117,25,134,12,53,266,490
9890,451,22082,196,256,4753,27738
950,156,10710,86,94,1885,12931
33322,2000,16203,817,705,4281,24006
11843,44597,431516,30810,19843,187207,713973
13019,498,5266,272,325,1467,7828
1111,157,4530,107,126,2194,7114
33537,18,182,1,27,109,337
4621,12,71,4,66,107,260
9851,80,751,37,78,326,1272
40831,2,76,2,7,14,101
40519,559,3659,244,233,1529,6224
9972,34,326,23,64,349,796
39113,37,3771,14,31,288,4141
30704,14,121,16,50,142,343
6624,913,25763,599,324,15642,43241
19193,712,26638,364,205,13310,41229
8628,18,921,3,34,159,1135
22841,16,936,8,24,201,1185
20899,45690,838665,15160,9023,66498,975036
15893,79,871,68,69,633,1720
2558,176,3298,178,183,1872,5707
10407,17,237,13,43,240,550
12067,377,12814,229,137,4501,18058
37714,7,55,2,43,46,153
1281,17250,74504,12117,6333,50483,160687
43795,0,11,1,7,10,29
6692,485,3895,259,230,1360,6229
2601,38,462,25,50,508,1083
36920,56,1992,12,51,481,2592
44141,0,0,0,0,9383,9383
31456,6444,27807,3309,8296,28921,74777
40479,6,67,3,28,47,151
1975,72,300,58,118,715,1263
18441,1583,81739,649,484,16887,101342
1156,314,4749,209,285,3896,9453
7044,831,21748,527,284,13904,37294
12049,2478,162376,1036,705,25311,191906
5713,342,21050,295,158,6289,28134
29900,14,112,3,40,58,227
3652,4728,124735,2781,2088,42729,177061
37364,478,13653,304,136,9135,23706
38621,372,1426,135,126,776,2835
48069,0,4,0,11,13,28
36936,2474,68806,1019,578,41971,114848
35543,36,125,9,69,128,367
5810,36,109,12,53,311,521
34973,6066,62084,2831,2498,28091,101570
33588,179,1070,84,90,574,1997
2279,55,2537,27,77,963,3659
3846,39,163,24,86,245,557
12411,123,4180,105,160,2166,6734
5226,1413,4024,1047,1114,9610,17208
14889,203,3039,99,92,1897,5330
49908,1,12,2,13,25,53
32648,15301,140546,7729,12081,70792,246449
1797,149,5875,99,91,2777,8991
13511,11,75,11,72,89,258
28955,6,288,5,32,67,398
28575,8,44,3,41,42,138
10213,15413,156434,7565,11381,78611,269404
44001,2,24,0,18,23,67
538,1024,22800,1028,1324,7545,33721
1413,129,3965,103,93,2409,6699
14067,15,191,8,43,141,398
35676,359,10081,153,319,3252,14164
40938,80067,253381,12973,21728,103596,471745
49125,0,0,0,0,526,526
26011,7,264,5,44,54,374
13601,94692,829763,63641,44360,396242,1428698
8092,37,517,34,57,760,1405
38558,157,1267,76,103,2979,4582
6956,16594,243160,11187,11781,114893,397615
45697,1,8,0,10,18,37
50072,5,114,0,3,16,138
31257,15,471,9,32,164,691
940,3100,35173,2754,3613,21299,65939
10933,366,13395,188,149,3646,17744
47161,67690,8,1309,5473,35738,110218
203,442,4691,282,294,2332,8041
41915,0,0,0,0,4859,4859
19921,27,99,6,49,210,391
17106,17,99,12,66,108,302
1062,269,5877,195,273,3627,10241
40058,3,130,1,17,20,171
39077,8,102,0,19,46,175
6007,2579,117387,1197,565,31199,152927
1415,125,4515,106,87,2219,7052
38153,6,139,2,21,77,245
26255,6,33,3,41,40,123
19367,2540,26833,2377,5621,13955,51326
39466,967,2093,377,236,1130,4803
942,917,7291,759,906,7343,17216
3868,92,1174,76,105,1773,3220
11597,24499,491440,11738,6706,128702,663085
43809,0,11,1,4,12,28
42845,7,63,3,11,24,108
37792,26,309,3,30,145,513
39190,3,13,3,23,47,89
48335,3,45,1,20,28,97
5941,5855,53150,4475,3788,45265,112533
2350,253,1505,128,213,1062,3161
40105,8,193,3,12,51,267
32370,11807,96962,5239,5426,54018,173452
297,1924,31513,1775,2466,14561,52239
35581,1137,10085,547,430,2604,14803
16021,19,83,5,47,139,293
74,2808,63306,3047,3160,18490,90811
1176,88,777,35,64,804,1768
23581,31,343,19,56,394,843
341,2047,27078,2602,2525,15224,49476
39728,412,6599,174,353,6591,14129
42468,6,33,5,29,63,136
6694,476,3827,266,275,1789,6633
8934,7062,50546,5482,7937,34527,105554
34535,814,734,368,238,4358,6512
17687,17,124,12,76,168,397
34450,75,636,54,91,952,1808
33779,38,264,18,67,316,703
16399,18,90,5,63,108,284
29053,5,177,2,35,42,261
2963,6942,83568,5501,5513,59092,160616
21715,7,238,3,27,51,326
33962,940,6580,487,359,2036,10402
32977,10853,49645,6173,5144,21828,93643
28085,41,1431,23,46,670,2211
2882,80,1041,105,271,508,2005
5332,115,7174,106,93,1982,9470
19325,12,66,6,54,71,209
28565,8,32,3,44,43,130
21749,25,122,12,46,271,476
17643,427,18496,324,155,7737,27139
238,3004,32200,3009,3086,18931,60230
30164,7,173,4,27,40,251
34432,7,284,3,23,34,351
771,229,2897,276,283,3270,6955
50474,574,5401,85,202,2372,8634
29923,15,404,8,51,154,632
2070,126,1073,70,111,890,2270
21201,107,7973,65,92,1387,9624
23769,17,61,5,45,97,225
23897,95,396,63,132,611,1297
17681,1724,12747,1192,2966,8011,26640
30165,11,247,1,42,47,348
304,609,31471,390,284,7357,40111
49567,0,0,0,0,914,914
576,1373,20310,1020,1461,8414,32578
665,2544,42396,1456,1604,22142,70142
44429,1,42,0,3,10,56
37464,7,105,1,21,54,188
48568,352,1582,146,176,468,2724
50041,3,256,1,4,48,312
10043,331,1385,190,167,980,3053
35204,428,1745,163,258,1515,4109
33089,4510,34591,2542,4476,28005,74124
31246,41,225,36,86,298,686
30193,19,189,10,41,200,459
1727,1725,13231,1247,1626,12430,30259
16988,13,124,5,64,78,284
15137,14,269,11,57,127,478
35333,5427,34184,1496,1388,18787,61282
43711,34,550,9,28,231,852
20003,19,91,10,94,126,340
35508,10,35,4,43,46,138
21701,44,654,31,43,573,1345
10526,63,891,37,125,568,1684
37031,612,7000,270,327,4930,13139
17543,428,2301,179,149,946,4003
13983,30,781,16,51,463,1341
5204,2467,130027,1411,458,38746,173109
5632,16,1106,5,45,192,1364
39101,7,69,7,25,91,199
16558,10,107,5,43,87,252
40031,871,7065,354,483,5060,13833
49205,16,28,11,21,59,135
37579,8135,43554,3523,6329,29581,91122
37969,27,490,25,56,763,1361
43989,3,26,0,18,23,70
2144,1342,167405,709,590,12660,182706
29105,8,417,5,41,52,523
26257,10,31,3,49,86,179
2753,274,4242,159,137,6048,10860
30649,315,1453,158,371,749,3046
1947,119,461,87,140,1055,1862
8446,15,317,5,26,145,508
4389,96,1841,55,127,992,3111
50425,0,0,0,0,3670,3670
45665,2209,3757,609,2673,9111,18359
22171,11,260,3,27,78,379
44146,0,14,0,15,13,42
43235,0,9,2,7,11,29
5267,237,1153,179,169,1537,3275
10792,578,3572,287,299,1765,6501
38477,7,139,5,7,66,224
40801,466,2146,195,183,864,3854
6555,86,4015,98,143,1937,6279
4498,113,881,64,94,601,1753
2718,69,715,76,154,734,1748
23885,9,113,7,37,93,259
2801,61,1159,45,72,712,2049
36270,7,12,2,35,37,93
21105,8126,178790,3596,7418,33575,231505
23439,107,3258,40,41,1281,4727
2569,156,4621,139,323,989,6228
4087,13228,59671,10664,6052,83691,173306
27373,10,87,5,59,74,235
20199,12,67,6,69,82,236
41930,22787,105602,7310,13267,68426,217392
29915,486,2504,256,234,1411,4891
30411,46,46,11,128,223,454
10313,24,415,25,54,330,848
41842,130,671,42,51,1318,2212
32907,8,84,1,39,31,163
34861,9,104,3,16,39,171
8422,694,26116,364,382,10874,38430
40090,33,74,16,47,160,330
7174,31,907,8,49,197,1192
43982,1,45,0,19,34,99
25809,20,85,6,57,126,294
40211,712,5469,189,160,7908,14438
2792,58,1724,34,64,841,2721
1676,195,2253,181,236,2073,4938
3008,190,2561,225,425,1193,4594
49342,0,0,0,0,3126,3126
35007,15,118,3,37,80,253
6522,16,89,9,53,135,302
36474,71857,623637,19298,26922,122822,864536
8245,104,3958,77,126,1419,5684
7354,21,179,19,105,189,513
32600,33,883,10,36,274,1236
39359,5,39,8,33,103,188
29906,7,375,2,25,82,491
5538,233,8849,193,135,4391,13801
36657,20,66,8,58,74,226
41226,32582,222959,9235,21140,73518,359434
1515,132,1732,79,74,1305,3322
48409,55,135,21,44,1046,1301
49194,3,12,3,11,31,60
32467,120,2534,52,73,1398,4177
33724,218,1209,123,121,2523,4194
3121,604,22576,443,364,4676,28663
35164,6,49,3,55,38,151
4264,388,1315,370,622,3582,6277
39919,4,108,1,10,19,142
20033,1927,27271,1246,2976,12784,46204
38311,3,69,1,19,25,117
49814,11,31,5,15,40,102
1478,141,3848,102,88,2056,6235
10278,9588,57998,7929,8648,57551,141714
36497,544,11281,260,284,5358,17727
37304,477,7650,312,139,9553,18131
37293,504,824,171,228,1656,3383
5723,87,1332,61,99,1347,2926
5246,45,577,26,72,483,1203
48829,31,355,22,41,361,810
35108,11,40,4,44,48,147
13115,2539,29653,1744,1604,18031,53571
12035,179,2612,82,90,3120,6083
48011,0,4,0,8,13,25
503,166,1998,135,179,1896,4374
108,310,7585,231,182,3961,12269
43693,0,0,0,0,2842,2842
3603,1837,36541,783,1216,18799,59176
1246,485,3825,420,561,5890,11181
35641,7,41,2,41,68,159
31604,14,77,8,49,84,232
34802,81,1903,19,41,712,2756
4355,226,1426,139,129,824,2744
43727,54,202,11,33,350,650
13857,15,285,7,20,112,439
24901,6,223,3,36,52,320
39381,1,15,6,38,30,90
23627,161,2141,114,172,2370,4958
3428,93,726,56,82,466,1423
39988,12933,145340,4335,3463,32861,198932
40941,611,1262,204,198,763,3038
33562,672,1444,237,343,4209,6905
35048,8,56,5,38,41,148
36955,42,361,24,70,841,1338
29941,649,5035,370,1842,2973,10869
30991,1346,55571,807,443,14909,73076
2799,169,3602,175,304,1167,5417
277,959,21211,809,709,6631,30319
37595,242,2766,99,128,2251,5486
41795,1363,1341,352,269,912,4237
22199,78508,1385480,33146,55408,235242,1787784
45600,112,175,25,79,221,612
1829,1258,98320,881,610,24750,125819
32423,1036,5810,579,376,3079,10880
34540,384,40633,240,206,5497,46960
37886,139,895,47,79,1298,2458
3225,2197,49020,2107,1926,13208,68458
36407,29256,336590,6215,24941,64391,461393
28299,880,37607,407,260,10217,49371
21327,14968,166524,10941,9979,82108,284520
42199,3,240,4,11,33,291
39002,6,42,7,36,137,228
2290,80,5857,36,42,1451,7466
1517,533,5480,597,666,5584,12860
31109,7576,41971,3573,16005,31184,100309
8457,1589,20289,839,465,13310,36492
40755,219,769,92,75,2194,3349
2471,4582,28848,4539,7786,5178,50933
39171,5,135,0,9,26,175
50282,6,23,4,21,112,166
1200,368,916,333,684,4749,7050
37316,14,306,6,22,157,505
49519,18594,2,620,2049,11141,32406
8479,6757,70168,5118,4466,18234,104743
49590,0,0,0,0,13499,13499
36483,871,5461,429,593,5789,13143
10620,77458,1331061,45432,66371,272015,1792337
33192,32,477,14,38,226,787
5464,1274,9694,718,521,4068,16275
9981,7145,50836,6412,10002,27607,102002
30050,14,88,6,48,109,265
50562,0,0,0,0,271,271
38310,6,100,3,23,30,162
34350,8515,50864,5850,11336,31675,108240
237,21212,202027,22399,18636,141191,405465
23351,41,147,38,99,412,737
40109,150,729,73,75,2154,3181
15125,2439,32777,1173,2042,21663,60094
14209,48,327,25,92,250,742
1560,172,1730,94,112,1410,3518
42373,2,50,5,30,38,125
30148,13,86,9,59,95,262
7423,13,332,4,27,132,508
19843,24,151,15,84,251,525
10000,18,134,8,54,174,388
5612,78,347,36,77,386,924
49134,221,159,57,33,442,912
40813,0,0,0,0,276,276
38092,4,43,4,31,37,119
22745,301,16072,175,158,3970,20676
24011,3398,21706,2027,10096,10105,47332
2805,39,473,35,112,302,961
368,3124,43682,1724,2879,9986,61395
44008,1,16,0,22,30,69
32422,11,270,3,37,131,452
2205,293,9583,219,157,4694,14946
21835,1132,2756,802,2349,2099,9138
37978,7,93,13,54,139,306
176,222,3372,154,203,2538,6489
31138,1929,56795,853,980,10127,70684
4097,18,273,13,59,234,597
36461,282,2479,176,148,954,4039
47987,0,3,0,10,13,26
7775,35,487,27,47,441,1037
39894,0,0,0,0,17524,17524
10355,38,568,18,52,616,1292
8011,50,297,35,116,436,934
811,736,15460,624,576,7040,24436
2754,107,1167,67,108,1394,2843
2095,57,545,40,76,657,1375
38850,68,1402,50,96,1244,2860
40304,2,111,2,9,17,141
42176,170,772,66,67,1025,2100
42799,1,61,2,16,28,108
8425,28542,245224,23161,21582,165802,484311
21291,12,119,4,63,83,281
32256,20,381,10,36,193,640
31513,6,466,4,28,48,552
7079,3272,36306,2483,4590,23056,69707
28013,7399,27585,3306,4196,26999,69485
1094,439,25085,330,224,5799,31877
11113,1187,52605,806,388,10079,65065
2927,4046,47912,3094,3457,26798,85307
8567,10,50,5,56,77,198
49210,0,0,0,0,1223,1223
36539,659,20544,297,164,7621,29285
38450,5343,45947,1280,866,27053,80489
660,122,1727,130,152,1219,3350
42736,3,69,2,7,15,96
9304,38,137,33,86,258,552
9885,22,129,8,72,150,381
3807,170,1102,133,162,1332,2899
35406,10,379,4,31,79,503
31967,177,2167,100,120,1659,4223
41115,11,70,9,30,89,209
1366,458,41306,217,226,3413,45620
8289,253,2916,163,125,872,4329
3251,34,138,19,62,219,472
40293,16,760,9,33,128,946
6622,137,826,87,134,664,1848
18897,47344,733861,25948,34173,189116,1030442
42517,1206,9260,337,470,7515,18788
26337,7,34,3,44,45,133
36275,1572,24219,588,276,12303,38958
33484,9,76,5,51,65,206
47403,77,108,34,58,625,902
40885,401,500,56,135,943,2035
36805,300,113,98,115,2415,3041
3113,35,585,20,58,382,1080
35631,168,1866,107,232,1968,4341
31643,9,100,5,29,49,192
1953,837,33608,917,832,11509,47703
3874,121,877,89,156,687,1930
21975,12,99,4,62,77,254
33095,10238,66042,5257,3349,80471,165357
41457,59826,244966,11688,11323,142754,470557
9882,55,189,36,72,676,1028
38054,22,325,4,21,215,587
40625,2,80,1,14,17,114
49796,0,0,0,0,124,124
29613,10,246,8,63,114,441
38536,2578,8247,808,682,18838,31153
47994,0,20,1,10,10,41
2997,82,1536,57,64,1383,3122
41852,1,253,2,18,44,318
1787,724,8758,371,337,2427,12617
23059,23,1197,17,26,346,1609
924,135,1736,90,169,764,2894
12789,22,436,9,64,166,697
39123,2,22,2,31,31,88
8363,63,3118,36,88,600,3905
29675,11,210,3,36,48,308
31139,399,6199,241,668,2476,9983
3945,147,878,110,110,786,2031
48698,262,2752,133,152,783,4082
15607,16,283,12,71,243,625
43990,1,25,0,19,24,69
12951,73,281,31,103,662,1150
38357,229,4825,97,104,2654,7909
33839,567,4025,202,365,12654,17813
7031,10,832,13,45,183,1083
43375,0,11,2,6,11,30
4854,112,920,83,98,1100,2313
46172,1,5,0,11,15,32
983,48,1799,67,58,896,2868
29359,13,84,9,46,62,214
170,19633,129471,14726,9238,73871,246939
22757,66,167,27,71,553,884
4492,278,1621,156,143,1052,3250
39769,11,1400,4,24,114,1553
18,7916,112086,3857,1655,21927,147441
30915,738,27203,325,319,7665,36250
7549,139,3147,67,62,1634,5049
35116,35,170,35,64,237,541
43344,0,7,0,7,12,26
32850,9,187,1,24,38,259
10357,10273,65653,8215,7579,81840,173560
29539,12,108,5,47,84,256
48646,3,27,4,17,37,88
6045,44622,485283,28765,24840,202484,785994
37765,662,12949,168,79,8846,22704
5034,2510,41185,1673,1334,25361,72063
26107,10,33,4,47,58,152
38561,58,32,30,48,592,760
18983,16,79,12,70,92,269
205,73119,646396,54347,23957,273960,1071779
26057,783,25193,414,276,10328,36994
2659,51,4248,42,97,482,4920
11497,15,71,11,61,107,265
42893,1051,11917,290,471,6943,20672
33902,327,8583,154,194,4051,13309
21941,12,106,5,60,77,260
43555,1474,27657,390,372,12517,42410
36586,11,152,2,21,59,245
48047,0,6,0,9,11,26
47949,0,5,0,10,12,27
48235,31,262,15,29,265,602
31918,1971,30569,1295,542,13722,48099
47947,0,5,0,10,13,28
33885,4,312,5,18,59,398
30029,13,65,4,65,105,252
50669,3,103,1,2,11,120
32152,3393,169,1334,1120,11935,17951
2650,33,1196,27,91,413,1760
28115,9,64,5,48,92,218
36221,25,23,8,42,59,157
4246,665,29482,524,446,12072,43189
27727,5579,35701,4594,10060,21023,76957
24275,46,250,63,85,595,1039
1656,21,171,14,81,138,425
12017,464,14642,229,180,10969,26484
8949,39,806,27,61,500,1433
8275,193,844,112,114,666,1929
11467,1013,11055,484,488,3134,16174
26165,5511,35359,4291,8238,39262,92661
5173,198,1197,126,120,707,2348
6090,66,907,34,45,661,1713
35551,42,1799,35,71,540,2487
37983,962,18382,346,198,9498,29386
41146,284,3671,94,89,2123,6261
28881,454,16780,187,201,6223,23845
4821,102,597,57,85,424,1265
33291,1548,3042,609,472,2119,7790
1759,100,2148,45,54,1285,3632
2597,149,10471,121,119,2077,12937
50255,2,4,3,7,32,48
1372,1974,10001,1741,1242,11709,26667
34705,9,18,3,43,65,138
33037,2231,9447,1296,2391,9884,25249
1024,101,3591,72,83,1446,5293
29925,8,126,2,49,53,238
9417,10,128,3,48,108,297
4567,50,877,18,69,451,1465
791,170,2682,87,101,2675,5715
39449,121,137,4,14,91,367
35447,27,274,17,88,170,576
43216,0,14,2,7,9,32
12579,297,3098,185,170,2791,6541
35805,107,809,63,97,1302,2378
1424,111,3465,101,96,2266,6039
48573,0,0,0,0,2857,2857
17703,51,125,47,144,527,894
6591,424,10749,242,195,5451,17061
1343,152,5071,81,121,2126,7551
48116,21,0,2,10,59,92
24803,7,40,4,56,54,161
35466,7696,245132,2586,1833,59041,316288
50063,5,147,0,3,28,183
33573,5220,37219,2713,3666,28584,77402
5832,171,3549,132,229,1418,5499
48555,197,257,47,141,599,1241
41470,24,76,12,51,521,684
3565,63,577,47,84,399,1170
24773,57,0,11,64,134,266
39285,4,218,2,16,30,270
48303,1,13,0,18,26,58
12815,10365,16193,9967,8197,39767,84489
48223,1,8,1,13,19,42
36291,380,1607,114,147,1671,3919
48777,0,0,2,0,6511,6513
39895,3,61,2,19,24,109
43659,0,14,2,7,8,31
3322,2028,13525,1921,1950,11160,30584
8756,351,10113,279,230,5218,16191
30383,7195,53657,5002,11153,36731,113738
45999,882,1583,310,296,5658,8729
5201,39,559,28,89,190,905
39020,23,538,15,35,525,1136
32816,78,2152,63,82,1015,3390
39170,2,166,0,11,28,207
4396,14,905,6,40,115,1080
41282,282,1795,133,156,598,2964
3840,837,5828,832,1494,6954,15945
34078,10,53,3,62,45,173
49737,5,196,2,6,41,250
39931,32,136,31,60,814,1073
14669,3140,39401,1114,591,37977,82223
6428,80,267,56,102,530,1035
47751,0,4,0,10,12,26
42491,30,205,12,46,120,413
16131,37,185,24,71,323,640
32625,482,7051,295,177,4525,12530
40520,893,1981,340,244,1125,4583
19973,107,2446,54,124,1460,4191
4640,50,356,24,59,721,1210
38485,15,267,3,32,128,445
32568,42,75,23,98,319,557
40091,8,67,3,36,69,183
37784,69,867,6,32,567,1541
38847,4,30,2,33,50,119
6465,962,5010,415,372,2593,9352
32083,7687,52635,3759,12772,24058,100911
1593,270,23097,236,189,5423,29215
1779,296,2200,211,195,1348,4250
34406,11,233,3,30,79,356
36883,17,150,2,36,125,330
43590,15,1232,4,11,98,1360
31234,2730,47690,1755,1402,15918,69495
1538,1851,19197,1944,2347,13287,38626
36793,20777,167913,8430,19712,65241,282073
1122,475,95602,280,274,4315,100946
6636,107,290,59,99,797,1352
621,733,8431,685,741,7488,18078
12477,6379,152207,2283,784,93134,254787
25293,34,222,20,38,320,634
24655,3043,130647,1349,671,38046,173756
38306,4,81,1,18,22,126
31321,17,295,5,47,109,473
192,408,44110,330,203,5192,50243
13047,31,510,21,73,357,992
4975,8838,183041,6867,13433,59750,271929
49683,2,105,2,3,65,177
6849,10,770,4,45,101,930
30205,11084,124604,5970,11819,51048,204525
5355,8251,75441,6404,7623,52133,149852
1132,2839,122224,2997,4927,8945,141932
25257,187,1881,131,136,3480,5815
23703,299,11840,174,152,3989,16454
41069,9,294,6,18,131,458
7081,568,4857,411,493,2324,8653
50126,1,23,0,1,4,29
33672,75,2946,74,110,740,3945
32809,11,116,6,83,70,286
24277,6841,92689,3641,2646,16429,122246
4119,136,335,89,114,1063,1737
29535,11,128,7,46,90,282
2622,71,1690,38,62,815,2676
136,35612,314254,19475,18540,120295,508176
43984,2,35,0,18,22,77
1555,1792,18388,1498,1841,11490,35009
28897,8,252,5,29,42,336
36978,11,68,9,59,62,209
23511,37,126,16,81,183,443
44248,12841,5715,2888,441,16103,37988
7491,51,713,35,51,710,1560
16560,17,165,10,54,133,379
12771,17,116,9,69,134,345
39316,51,521,37,62,606,1277
40969,166,577,51,81,798,1673
38363,10,112,8,63,136,329
15959,695,15689,325,164,6205,23078
19319,3789,43779,2213,2762,14293,66836
510,308,1893,246,313,2840,5600
36411,45,0,14,51,82,192
31511,6,63,1,39,35,144
44200,3364,41155,1501,251,96793,143064
41853,10,900,4,6,74,994
34649,282,1022,116,120,4867,6407
37334,12,581,6,31,156,786
38036,534,1615,236,187,840,3412
31259,17,457,10,38,147,669
32058,60,636,26,51,599,1372
44010,1,21,2,21,22,67
19009,14,270,8,34,218,544
7611,369,1921,204,179,1220,3893
1254,10918,107050,8771,8553,30876,166168
38513,374,3512,203,195,865,5149
29857,9,116,0,30,63,218
35814,431,8527,200,178,6511,15847
19191,753,31919,398,219,13606,46895
37735,582,6956,181,447,4182,12348
38650,50,523,26,60,541,1200
37498,1945,38270,689,741,30704,72349
3104,86,290,83,126,878,1463
5383,135,931,59,111,606,1842
18455,434,4206,240,194,1024,6098
151,987,12090,671,584,11135,25467
36949,32369,495233,6862,5062,74264,613790
34388,2751,4641,975,559,3689,12615
2335,376,4733,423,422,2276,8230
16257,22,99,11,54,248,434
5875,47,2418,15,60,404,2944
37013,48,88,30,53,1425,1644
42198,8,54,7,20,43,132
35534,8,86,2,18,28,142
30144,16,129,11,91,196,443
33982,13,54,2,29,86,184
42898,236,883,32,75,236,1462
367,62,1441,71,94,789,2457
28109,16,46,7,51,136,256
32313,1866,16456,1182,1350,12079,32933
14123,185,13911,112,171,2013,16392
37818,104,59,44,73,675,955
21235,479,12635,292,369,5704,19479
8889,49,711,25,50,519,1354
30514,1094,26690,560,421,14292,43057
40134,398,4328,156,102,3689,8673
4460,121,5689,47,71,2252,8180
3151,55,401,61,146,513,1176
33026,434,949,242,1164,1676,4465
31405,15671,92997,9334,19823,58675,196500
36629,157,1954,115,81,2396,4703
43676,0,6,0,8,10,24
28645,9,830,8,28,121,996
38057,65,73,34,52,951,1175
2631,25,855,23,84,331,1318
13659,11746,318029,5659,9540,54790,399764
16149,287,12951,124,99,5148,18609
6714,256,15316,201,274,3642,19689
22457,9,135,7,44,95,290
907,2331,36853,2213,3324,15029,59750
46276,1,6,0,11,22,40
11017,112,757,61,163,778,1871
3389,463,19110,433,659,5570,26235
38162,674,3246,335,1992,3653,9900
2077,106,1549,58,68,1276,3057
42323,3,17,3,13,43,79
41141,0,0,0,0,3434,3434
46256,1,4,0,10,20,35
48880,173,1970,114,86,1168,3511
9810,37,524,45,127,200,933
19845,334,5055,332,356,4297,10374
38449,565,1801,292,2549,3823,9030
24031,7522,60603,4515,6566,40862,120068
34162,7,87,2,35,46,177
349,251,1818,168,269,2520,5026
10964,36,239,19,50,330,674
3744,70,3275,46,99,755,4245
3100,31,839,17,38,349,1274
37476,1319,4846,650,915,2392,10122
31417,1893,13157,1322,1804,8539,26715
25729,402,4138,246,135,5827,10748
17873,571,29564,524,724,5428,36811
40267,1409,1566,433,1007,13860,18275
48007,0,7,2,16,13,38
43722,5,255,4,16,56,336
39999,147,2140,91,154,1806,4338
34580,6127,35451,2925,7326,19046,70875
44070,643,19032,168,174,7722,27739
1546,4534,44781,4045,5117,27250,85727
4082,244,7396,151,107,2961,10859
49730,1919,5903,277,185,1838,10122
4154,69,1099,56,156,456,1836
37720,3,99,1,16,26,145
41708,7,119,1,7,34,168
2050,143,3495,88,87,2238,6051
5165,61,1948,52,85,1149,3295
38074,5,100,7,44,41,197
38774,60,74,16,50,76,276
8987,583,3269,289,233,1583,5957
38246,4,47,4,28,57,140
34034,15118,40686,9364,13319,11444,89931
37100,7,86,5,55,50,203
854,934,10375,767,1409,7431,20916
4872,1411,39370,1009,517,18235,60542
41609,3,46,5,26,66,146
50675,0,0,0,0,871,871
16415,52,835,50,88,958,1983
48970,4,81,2,8,29,124
34458,10,64,1,36,55,166
36439,517,15721,363,387,5981,22969
41634,74,224,18,56,381,753
50258,50,93,11,12,327,493
6154,202,6702,121,164,2142,9331
32944,34,73,24,99,382,612
42888,1,95,1,11,15,123
50383,6,70,0,5,18,99
36803,646,8196,359,170,13541,22912
30537,84,853,69,76,1766,2848
34012,17235,107782,7592,13388,55671,201668
23487,627,6525,415,273,5602,13442
31108,104,2247,78,122,1166,3717
11743,2228,84817,1122,539,29743,118449
30983,7,27,1,49,40,124
27501,12,114,4,59,75,264
30927,9,36,4,51,46,146
767,201,4483,135,116,2850,7785
39486,4586,44831,1021,799,40602,91839
30925,476,17310,284,220,5621,23911
44025,0,3,0,0,1466,1469
7416,11,118,5,33,98,265
7247,71,208,38,144,225,686
34295,576,5336,248,551,2586,9297
38931,25,41,6,27,70,169
37997,393,11048,236,179,6700,18556
37979,6729,27674,2384,6991,29151,72929
1692,240,6527,171,276,2477,9691
13535,9381,129032,6111,6672,62091,213287
32073,6,87,2,33,28,156
41709,3,106,2,6,30,147
38937,189,2397,90,123,2294,5093
39912,220,1529,33,86,377,2245
35363,3079,152437,867,458,25771,182612
36185,330,2057,108,167,2071,4733
6217,63,3463,34,92,663,4315
50161,1724,1,490,155,1137,3507
37328,60,137,45,131,557,930
8896,31,374,13,44,476,938
30544,25066,442379,8936,21365,82236,579982
31414,13540,113700,6750,7789,63872,205651
33123,17,60,6,50,77,210
31683,299,17622,156,67,2818,20962
37717,70,316,27,40,560,1013
38886,3,143,1,12,26,185
9575,21,271,6,48,144,490
2187,158,1118,95,107,595,2073
1384,633,10000,467,418,7439,18957
7578,66,1124,71,69,1608,2938
31582,13,185,6,30,129,363
31673,35,836,15,84,103,1073
40808,0,0,0,0,347,347
48708,0,0,0,0,487,487
4192,4348,72524,3329,3386,23920,107507
3384,164,792,92,95,572,1715
37670,8,120,1,15,28,172
9549,44,1190,32,75,371,1712
10850,16,82,10,61,86,255
49121,2,13,1,17,29,62
43284,0,9,2,4,10,25
6875,1251,14315,1009,3687,6411,26673
22663,12909,199162,4822,10405,46251,273549
32548,167,2216,49,82,1829,4343
28977,57143,212341,20342,14241,208734,512801
19159,289,11060,178,113,4850,16490
29972,7,213,3,21,56,300
31463,32,62,10,36,247,387
48422,1996,3,635,257,1139,4030
24237,18,162,3,44,109,336
3470,13400,228023,10216,15795,68350,335784
2148,1228,34886,592,1405,4773,42884
40684,11,333,3,9,44,400
3573,60,187,53,148,580,1028
41555,121,814,46,101,486,1568
1006,423,16642,210,155,4289,21719
47959,0,4,0,8,14,26
36513,2506,12192,899,1490,10270,27357
1404,134,1121,89,93,626,2063
20547,53,747,41,83,733,1657
8438,115,6163,124,146,2283,8831
10751,41,413,15,49,374,892
36780,5,210,0,11,53,279
1684,173,1809,155,228,1240,3605
2465,101,639,51,100,1325,2216
29961,15,204,5,37,114,375
11009,115,6399,131,216,2241,9102
50430,154,0,15,18,251,438
10611,4474,48595,2825,5420,23940,85254
1858,1128,11922,1286,1399,12918,28653
3449,190,7547,196,104,2238,10275
37986,1823,58860,726,361,28087,89857
29273,9,76,4,49,75,213
48930,1,57,0,4,13,75
40055,0,0,0,0,3563,3563
38327,1,79,2,20,22,124
13283,759,6831,415,394,6577,14976
27509,400,7704,214,186,4382,12886
3039,177,1680,123,140,826,2946
7453,188,2681,111,124,1672,4776
10525,27,240,13,105,274,659
8231,229,5852,186,190,3029,9486
48505,11852,3,628,630,16682,29795
33883,278,733,67,102,1438,2618
5163,800,22256,822,672,10666,35216
1386,255,2600,166,229,1537,4787
3713,4023,50261,3683,2636,35072,95675
8278,188,4435,104,134,2558,7419
2464,30,697,29,47,422,1225
19053,13,113,4,40,89,259
33237,20,50,3,42,130,245
50084,3,66,6,18,70,163
7805,460,30917,330,262,7676,39645
16610,20,3909,7,50,278,4264
28691,14,722,5,42,104,887
30746,590,7460,315,990,3046,12401
5214,392,2667,240,192,1520,5011
6467,649,43418,266,307,4886,49526
752,108,5920,73,153,1433,7687
34527,19,79,12,55,183,348
28145,22,106,10,80,128,346
51036,2,39,3,7,39,90
34355,7,55,9,48,57,176
1136,660,4699,767,838,6374,13338
30952,428,14447,188,190,6373,21626
19797,14,61,4,34,91,204
3462,61,1130,38,48,953,2230
6205,10422,177673,6080,13764,51965,259904
20649,531,11783,323,232,4965,17834
1874,96,3709,89,89,1109,5092
33094,7660,87627,3780,4943,37593,141603
41370,229,2452,151,142,807,3781
37232,2768,8895,1253,4119,10234,27269
8652,316,2080,175,179,1046,3796
23551,449,8068,242,394,2752,11905
30864,8,165,3,29,44,249
6920,1192,13584,845,2077,7798,25496
43461,0,7,2,5,11,25
8195,17,129,13,64,145,368
6227,76,835,51,61,816,1839
3683,36,263,22,106,184,611
36951,375,8890,209,134,8403,18011
11777,127,3987,98,93,2148,6453
16868,923,43408,445,218,12702,57696
28883,4593,51564,3039,7905,24958,92059
27811,44,220,22,69,237,592
33318,9,138,0,20,45,212
7867,131,655,116,348,604,1854
6512,9891,170070,5664,6541,52139,244305
3410,121,2231,115,112,1164,3743
2988,620,4015,356,332,2692,8015
497,1276,12134,1169,1608,11217,27404
9228,31,442,16,78,404,971
1709,399,64913,216,199,3818,69545
32281,50115,1954614,5944,3227,262602,2276502
10015,3964,42672,3183,7504,8946,66269
3848,637,45822,470,387,8511,55827
4688,93,1256,47,62,934,2392
3564,78,654,47,75,368,1222
2234,95,889,173,281,703,2141
21947,13,120,4,63,75,275
14353,3026,169557,1137,572,42762,217054
27619,651,5589,340,284,4900,11764
8062,112,3642,67,59,1816,5696
25607,8,36,4,57,58,163
32633,115,356,75,78,980,1604
23313,14,130,8,63,105,320
3819,112,384,63,144,785,1488
2883,369,3726,201,179,1527,6002
28859,580,3361,300,246,1739,6226
19383,4618,52945,2390,2809,31701,94463
3761,76,1935,88,182,418,2699
26329,10,33,4,46,51,144
40002,13,233,4,27,84,361
33607,18,46,10,49,139,262
38082,0,0,0,0,12781,12781
17317,7,63,2,56,72,200
40578,106,1627,55,56,1871,3715
40716,27208,129361,10389,9163,97289,273410
39463,39495,206135,11734,26356,105831,389551
1957,146,3651,119,132,1363,5411
2001,82900,920640,64750,49318,293040,1410648
30267,4,49,2,36,45,136
351,694,13683,561,502,2870,18310
12893,2929,94754,1653,851,21939,122126
41028,4,31,2,22,186,245
40288,5,122,3,9,17,156
5147,80,1694,89,60,1182,3105
35985,7,69,3,39,63,181
1982,29,2722,24,56,410,3241
9314,3368,40231,2902,4116,27526,78143
19941,16,59,6,42,133,256
28235,78,1607,35,73,1342,3135
49057,2,24,2,11,21,60
33753,12,100,5,47,82,246
8111,499,2731,267,237,1696,5430
6012,44,280,27,82,491,924
33589,5541,25672,2209,3269,37083,73774
38431,1375,19503,599,347,7170,28994
42483,2,83,1,6,20,112
37690,4,123,1,18,26,172
36824,805,2269,243,193,3073,6583
1490,543,3376,593,610,5704,10826
3222,121,1978,103,107,2006,4315
45703,1,7,1,13,15,37
2810,139,3194,131,203,1362,5029
8985,500,15341,375,232,6745,23193
49759,0,0,0,0,134,134
21167,3859,27015,3061,6034,17826,57795
1785,429,5755,262,295,1927,8668
3951,127,718,77,107,561,1590
50146,1,37,0,1,4,43
38497,12,116,4,37,89,258
2256,39,713,30,56,596,1434
26223,11,61,3,43,55,173
5889,44,453,11,60,239,807
157,6095,79062,5427,7932,31822,130338
29976,6256,67471,3184,9096,26787,112794
38520,26,831,5,24,175,1061
24377,708,4699,359,269,1847,7882
20969,123,1523,61,56,1715,3478
34990,43,0,14,73,79,209
48471,20730,35789,3082,4740,45344,109685
38974,4,379,3,13,49,448
49338,345,596,81,39,3172,4233
7497,28,766,10,57,166,1027
25965,19,549,10,67,86,731
35799,9,53,4,30,32,128
36500,190,2268,74,112,1084,3728
32740,794,13051,585,210,6033,20673
20267,237,4170,140,308,1200,6055
22977,14,129,7,64,96,310
3359,2825,31190,2928,3362,14881,55186
35914,17,50,8,105,83,263
31054,20,144,10,63,165,402
37278,418,6453,308,308,5443,12930
50091,18,367,5,17,84,491
12879,294,14918,201,114,4966,20493
49413,0,0,0,0,21416,21416
34346,26,252,15,47,434,774
30944,7,41,3,47,61,159
51047,3,38,0,1,6,48
43525,0,9,0,5,10,24
36029,2184,3750,860,4557,7767,19118
10436,16,710,11,50,193,980
32801,2421,122815,718,494,26756,153204
16436,212,11926,77,179,2417,14811
39681,3063,10914,866,1092,10085,26020
42767,3,71,2,5,17,98
33945,14,99,3,38,71,225
44940,12782,22414,826,477,35052,71551
38420,13,49,7,28,82,179
16255,28,328,15,40,312,723
16918,12043,144924,8433,7657,88621,261678
1199,1721,0,1000,1392,2187,6300
8999,60,137,11,49,145,402
38776,59,0,21,151,126,357
1147,229,7390,150,128,2894,10791
1084,207,6092,191,199,2678,9367
49529,4,75,2,6,26,113
19557,19,171,13,69,97,369
24151,3030,103426,1535,605,20349,128945
4803,152,802,92,106,601,1753
867,270,13035,211,128,4101,17745
45935,8,12,0,16,97,133
41211,438,483,159,127,552,1759
4195,771,22780,427,353,5835,30166
39763,0,0,0,0,1627,1627
3670,338,3846,283,243,3378,8088
12961,1603,2514,602,358,2291,7368
1000,2137,10773,2048,1230,15998,32186
34543,3679,18756,1964,6515,16472,47386
2403,4275,62657,3068,5854,27848,103702
36777,216,2523,104,90,4663,7596
4198,172,1129,165,207,1150,2823
658,4644,46366,3907,2833,33379,91129
8158,45,306,29,75,444,899
953,2098,38663,1710,1979,22851,67301
3642,201,2373,73,112,2374,5133
13543,15,323,5,32,95,470
35542,37,145,9,65,134,390
41873,8,133,9,7,101,258
82,1209,34487,657,434,12970,49757
36249,10,133,1,13,24,181
5101,33,854,26,69,296,1278
24139,30,928,17,48,380,1403
14289,21750,416888,10885,16034,112868,578425
1501,97,4692,75,94,1691,6649
51092,0,0,0,0,330,330
32670,120,313,71,158,702,1364
16508,161,2656,99,122,1369,4407
5189,34,344,28,102,207,715
34498,4796,110609,1497,1338,61431,179671
20463,17,510,8,38,225,798
48567,4103,5615,659,3194,16951,30522
2102,102,1568,62,71,1051,2854
33190,1536,17082,670,291,21779,41358
38883,51395,570541,10630,3967,96679,733212
43522,5,822,3,9,34,873
38828,6,32,5,37,71,151
22111,20,79,7,51,135,292
26239,8,39,4,49,59,159
37559,32,113,18,110,247,520
41283,300,1012,107,260,1248,2927
42328,1,50,2,18,32,103
9322,2756,19166,1169,917,5804,29812
49399,0,24,1,6,11,42
50629,89,0,9,15,125,238
5539,111,2041,74,103,1713,4042
1364,637,50460,264,297,4039,55697
50774,3,139,3,2,13,160
50565,104,0,4,18,79,205
17827,8010,67178,3937,5509,38491,123125
25939,1475,11477,937,1221,8601,23711
3185,83,533,92,130,937,1775
10774,43,190,17,85,259,594
35854,0,0,0,0,1494,1494
676,95,1020,63,115,921,2214
17903,18,72,6,46,182,324
29537,11,105,7,51,80,254
50475,748,5830,137,151,3626,10492
30082,7,141,2,32,35,217
3572,7019,76918,5641,4710,42877,137165
34763,36,145,19,56,322,578
5014,51,811,28,43,628,1561
48697,417,2982,178,155,1115,4847
31629,15882,77043,7843,13692,56797,171257
22241,12,188,12,76,186,474
29543,8,66,5,46,72,197
29901,12,82,7,65,93,259
5717,696,25509,407,330,5128,32070
32747,8,343,1,24,46,422
679,143,3204,93,104,1577,5121
26243,50862,813503,22332,29426,214261,1130384
21273,13791,99427,8449,8519,81050,211236
27389,9,42,2,49,62,164
2094,62,929,27,49,670,1737
36094,4585,17556,2498,4009,26973,55621
31064,130,1418,86,100,1196,2930
35671,6,99,2,25,31,163
48916,0,0,0,0,13613,13613
32660,22,94,11,57,179,363
41459,0,113,2,9,24,148
39373,2,17,4,27,35,85
34440,1747,41876,792,637,33620,78672
1121,359,81680,246,248,4016,86549
2671,58,4183,43,104,544,4932
39080,446,1688,71,162,797,3164
48304,1,17,0,15,33,66
40140,7,448,7,14,71,547
33685,174,2651,106,202,2062,5195
45527,1,9,1,14,16,41
29271,10,87,4,42,67,210
25967,17,445,11,70,96,639
21867,224,8644,79,158,2307,11412
1547,29,213,32,141,259,674
30155,32,1114,17,45,355,1563
35663,7,121,1,12,32,173
32889,19,162,5,54,92,332
550,7765,166926,6174,8474,22236,211575
30766,19,429,2,35,115,600
42260,1131,3553,292,2801,7091,14868
38120,4,94,1,52,40,191
4685,55,1369,24,50,707,2205
107,1468,17363,1517,1812,12849,35009
42542,2,43,1,15,27,88
48065,0,4,0,10,12,26
7458,521,2499,241,207,1447,4915
13167,17,82,6,73,125,303
37578,3957,25452,2039,3946,17787,53181
33957,33,396,23,63,249,764
44192,897,4094,315,230,2236,7772
41491,65802,138231,12649,20402,88120,325204
17635,739,7854,427,271,6697,15988
3299,2952,58429,2607,4139,22783,90910
2246,17427,86383,11424,5773,148481,269488
1825,204,5988,167,94,4284,10737
2431,216,1601,127,122,735,2801
28101,10,68,2,55,90,225
6948,787,35967,489,571,10905,48719
42666,2,72,2,8,16,100
7045,74,7399,74,115,551,8213
48224,1,5,1,12,17,36
2697,67,316,63,71,757,1274
34184,13,32,5,34,75,159
30736,21751,97128,8747,9012,78010,214648
40408,2,30,4,24,43,103
43457,5,110,2,5,21,143
49371,1,39,0,3,7,50
42637,1,72,1,11,15,100
50917,0,0,0,0,1400,1400
5895,23,195,9,47,443,717
1367,553,44573,254,291,4034,49705
39884,132,1750,41,67,1245,3235
28791,4722,36152,3083,10395,13830,68182
10483,139,4243,97,92,2473,7044
26447,8,163,3,38,63,275
8154,30,258,24,66,349,727
35237,1205,44028,434,460,14519,60646
42906,23,56,13,20,252,364
38094,2,30,2,33,29,96
41797,4,113,1,13,36,167
38496,8,127,1,35,51,222
10477,225,8456,187,156,3757,12781
40711,250,1682,76,130,2382,4520
31931,7073,41382,2341,1849,33738,86383
39189,2,12,2,22,31,69
38731,11238,40370,2517,1379,16756,72260
29836,11,120,9,71,98,309
5411,82,902,68,89,591,1732
12981,30,95,23,40,530,718
3726,45,670,21,46,498,1280
7601,35,226,27,45,381,714
38175,42,131,27,65,367,632
40429,285,8690,144,91,7306,16516
6877,108,10095,112,142,1882,12339
40858,2239,39644,989,476,30021,73369
6023,2068,51438,1571,1837,10586,67500
3077,653,842,452,515,2874,5336
37391,10,121,3,41,52,227
42592,281,3522,155,161,785,4904
40042,22,157,8,13,117,317
32412,379,2264,292,238,2917,6090
761,615,68394,419,352,8167,77947
20469,43,326,15,44,532,960
19817,12,74,6,44,99,235
50849,67,0,6,21,81,175
40722,82,18,53,6,8248,8407
10763,22,289,10,58,173,552
35691,13,62,6,31,82,194
37283,804,6769,315,686,1913,10487
35706,26,634,15,25,399,1099
10495,15669,171892,10884,11991,100122,310558
37546,6,186,0,19,53,264
1303,1183,55026,673,610,15122,72614
40456,19147,824207,3175,1159,200127,1047815
37551,18,399,2,18,135,572
2618,718,7287,486,401,7974,16866
11589,24,108,11,49,207,399
48273,8,115,7,15,53,198
12877,70,1623,69,113,1289,3164
3114,48,252,39,90,557,986
10693,127,1655,90,114,2155,4141
6262,97,538,86,160,637,1518
37458,4214,24923,2034,4961,19229,55361
17209,11,196,6,40,71,324
2443,122,611,71,100,459,1363
28673,402,1154,211,359,3649,5775
43212,1,32,2,9,13,57
1623,219,1833,177,272,1743,4244
49847,430,809,67,54,1924,3284
26217,15,55,4,45,75,194
30859,11,648,6,29,107,801
1048,1031,8857,1185,1827,11059,23959
938,170,3265,69,118,1507,5129
2778,54,626,40,64,544,1328
39174,10,395,3,11,49,468
34037,8,86,3,34,52,183
50058,6,343,0,5,43,397
2946,283,3109,173,267,1336,5168
23665,447,3203,253,227,1571,5701
33078,11,40,2,39,47,139
47996,1,8,3,15,19,46
36973,18,110,8,41,126,303
6209,127,3821,144,102,2050,6244
38489,68,519,23,54,506,1170
4917,32,448,18,49,365,912
471,860,8890,714,786,8237,19487
17621,24,206,14,77,270,591
3916,459,2660,237,205,1716,5277
43229,7005,22056,2271,4653,19237,55222
25545,8,187,2,33,35,265
34779,6,36,5,11,965,1023
8783,28,433,17,63,313,854
41384,47,0,30,82,127,286
9239,33,481,17,52,441,1024
3192,78,877,39,65,1091,2150
43691,7357,20106,1656,2097,29044,60260
3369,409,3486,270,245,4027,8437
33835,36,82,14,73,157,362
46471,54127,83018,10931,36728,100532,285336
15061,5391,10086,3384,4126,14852,37839
32808,12,119,5,77,65,278
48326,3,12,1,19,27,62
28833,10122,46358,4182,7917,39855,108434
29395,8,195,1,38,52,294
5052,76,437,100,213,723,1549
35425,245,1868,177,108,6449,8847
29820,22,205,22,66,222,537
31397,4869,628,1079,589,2371,9536
1543,1879,19862,1273,1345,13037,37396
19841,1310,18730,854,1447,8255,30596
41750,0,0,0,0,4238,4238
8749,7,102,5,37,74,225
33836,17170,88889,6830,18838,73345,205072
40768,49,0,30,39,76,194
1007,660,22523,488,330,5245,29246
2666,44,3215,41,100,511,3911
6268,30,252,19,42,671,1014
28223,73357,1054559,42936,33258,301631,1505741
1288,1352,13392,797,430,13618,29589
43506,53,172,18,31,747,1021
19559,13,69,8,44,111,245
29814,12,115,2,42,67,238
36300,6,80,3,22,23,134
3171,308,2287,213,191,1162,4161
4461,32,1435,14,27,501,2009
50738,0,0,1,0,29934,29935
37071,9,100,2,18,28,157
3563,136,693,72,112,737,1750
567,3979,41570,4500,3335,30569,83953
13349,1762,8804,1647,1859,12898,26970
35981,22,170,7,26,122,347
6056,62,363,58,108,658,1249
3111,85,1961,40,63,1210,3359
39022,301,851,142,318,1971,3583
2480,94,742,59,85,520,1500
47,11015,531744,4386,2754,151891,701790
38030,675,5018,329,317,1312,7651
2870,398,4652,220,239,1563,7072
43975,0,12,0,14,10,36
50930,93,0,21,14,322,450
33811,449,9431,165,211,3004,13260
12903,21,106,4,56,198,385
4427,84,324,76,118,631,1233
352,610,13127,606,722,3360,18425
33499,18,312,9,58,134,531
4999,7513,140381,4239,5825,33207,191165
22535,81446,1196879,38340,28146,234898,1579709
39535,93906,594552,9058,10947,153062,861525
36470,20133,129885,7054,9446,79143,245661
39329,57,353,39,63,750,1262
2337,280,1134,235,196,2580,4425
19799,1052,9192,495,776,8340,19855
24797,9,53,5,37,45,149
34744,14,36,6,34,84,174
3372,17,70,5,60,127,279
34822,27003,252785,12088,12273,155855,460004
3480,56,703,37,50,748,1594
7569,25,657,11,25,248,966
38790,32114,271406,9578,15816,66973,395887
1352,993,11526,416,278,10665,23878
40758,47,133,23,99,518,820
4012,106,5286,35,83,1280,6790
1855,42,900,30,56,538,1566
36553,223,3806,103,148,2646,6926
35126,6,64,9,48,80,207
9834,4411,44075,3663,5132,30552,87833
8353,23,94,9,73,246,445
8042,48,573,27,53,738,1439
1286,123,5530,79,71,1557,7360
9120,736,25978,402,344,8123,35583
8098,393,6933,216,190,5568,13300
4823,146,1136,134,255,1170,2841
12859,3421,198117,791,559,19931,222819
40209,6,163,1,10,45,225
32233,33,2065,3,49,172,2322
2539,457,4995,263,240,1750,7705
36914,514,8514,304,220,7504,17056
32571,419,633,264,753,625,2694
36876,866,1953,386,282,1560,5047
1468,337,9695,146,116,5252,15546
38124,4,93,1,51,31,180
41456,40598,146047,7452,15276,73403,282776
38186,22411,236036,7585,12636,84604,363272
1270,343,8074,134,105,4887,13543
1529,86,1308,68,103,1128,2693
50205,0,0,0,0,4467,4467
2011,213,3147,153,118,2159,5790
1188,107,1052,75,139,1064,2437
40889,6,122,2,6,24,160
29645,9,209,5,39,84,346
1348,296,5692,183,144,3566,9881
45765,2,8,0,11,22,43
22247,22,103,17,62,200,404
44155,0,13,0,15,10,38
42164,7,0,8,21,34,70
17339,28,198,11,41,266,544
689,92,4129,77,61,1236,5595
23061,20,484,11,37,248,800
6667,15,1093,9,37,224,1378
14627,202,9927,125,111,2235,12600
1996,134,6469,106,110,2459,9278
39335,7,239,1,20,55,322
1783,615,5486,349,378,2815,9643
29403,11,51,5,50,46,163
37966,193,14836,154,222,4658,20063
796,54,957,29,66,723,1829
47990,0,6,0,11,12,29
20853,18029,210110,10610,12774,94541,346064
19285,2266,98930,907,1023,19787,122913
30169,8,184,1,29,51,273
586,2549,27540,2411,1857,30975,65332
29421,63,0,17,77,92,249
50176,5,16,4,4,29,58
38927,20,0,12,34,50,116
30668,11,575,7,39,145,777
5151,32,204,37,63,690,1026
30105,6,245,2,39,75,367
36288,402,661,143,362,2950,4518
19583,9,62,2,45,62,180
32664,4615,38482,2501,5545,11929,63072
1630,83,2228,78,98,1257,3744
35839,31044,205869,13882,8730,164500,424025
38027,397,11229,246,166,5862,17900
4985,507,19361,357,289,8558,29072
3636,465,3345,270,217,1459,5756
49104,9,434,2,4,22,471
33036,3205,53442,1217,519,37775,96158
34972,627,8748,288,183,13672,23518
180,2249,55744,1904,2573,15555,78025
337,395,6149,319,535,3238,10636
35432,37,308,14,57,375,791
3484,91,1744,67,68,1486,3456
48048,0,4,0,13,13,30
44570,16,50,9,23,93,191
6787,497,4799,268,418,4982,10964
40347,24,243,11,26,198,502
45790,1,6,0,9,16,32
49566,0,0,0,0,1209,1209
22985,15,363,9,53,197,637
34116,10,105,0,24,33,172
6747,9709,129624,7109,12071,49796,208309
9930,262,17683,100,153,2099,20297
36361,7,123,1,20,36,187
36390,32,80,2,26,65,205
17623,13,105,10,78,99,305
3516,19,308,19,60,205,611
23837,53,1662,11,42,432,2200
669,271,7097,258,290,3361,11277
9839,142,3103,100,140,1895,5380
22635,16,125,8,66,143,358
2284,164,3104,144,290,753,4455
30438,25,690,14,58,144,931
2207,46,1354,50,50,809,2309
28143,26,466,8,59,220,779
1946,1508,12792,1798,1449,10468,28015
35859,28,380,27,34,399,868
49304,0,0,0,0,1495,1495
43582,0,10,1,5,10,26
9917,289,44032,253,255,4576,49405
13465,12,71,7,64,124,278
30873,16,88,6,44,141,295
49471,20,53,21,24,1099,1217
37407,1896,28883,733,289,31737,63538
9857,31,546,14,88,254,933
5314,22,266,23,59,322,692
38852,14,535,4,12,79,644
32289,19,732,5,45,96,897
14749,22061,327835,10677,15175,111764,487512
31174,14675,68097,11131,13010,50195,157108
34878,15,241,14,35,246,551
2025,43679,493982,35990,25176,249624,848451
41096,7,124,5,44,112,292
20241,15,66,5,62,86,234
25079,23,179,7,64,180,453
22711,10,62,4,59,75,210
20849,1010,12249,501,404,3250,17414
38029,6,106,4,30,53,199
33430,52,758,27,115,146,1098
15731,917,8403,673,599,8047,18639
6712,955,9547,630,511,7377,19020
33183,80,1589,51,112,1119,2951
1171,318,13880,268,162,4280,18908
48449,1302,1375,421,168,1248,4514
48252,2925,5485,550,1109,5458,15527
33155,186,4299,185,232,2818,7720
40879,6755,24994,2060,2097,22259,58165
12729,14980,206974,3336,1921,24895,252106
42756,416,4297,214,195,1171,6293
31980,895,32324,362,180,7061,40822
36894,47,260,16,104,195,622
10342,51,714,32,114,604,1515
50469,0,0,1,0,1490,1491
35818,190,2002,101,279,1282,3854
36152,36,92,13,45,470,656
34121,12,306,1,27,60,406
39167,0,0,0,0,7367,7367
41783,8355,32042,3025,8996,26414,78832
31043,62094,1405171,18881,14226,266703,1767075
32695,46,505,9,29,309,898
51048,2,34,0,2,7,45
24417,53,269,46,105,423,896
35314,800,31073,328,189,10440,42830
33396,182,292,52,124,533,1183
34799,406,684,178,568,1148,2984
38065,37,1490,16,31,356,1930
36572,9,71,1,25,43,149
1981,174,3071,103,101,3275,6724
33566,466,9351,161,183,4108,14269
36828,7313,25751,3078,11831,23600,71573
48762,2,19,6,28,37,92
9367,10571,215384,5623,12675,51633,295886
13219,822,4838,445,318,2205,8628
25907,912,15050,407,354,13112,29835
8216,103,583,65,149,618,1518
10547,379,7882,204,166,3695,12326
31924,12,59,3,52,56,182
11933,12533,175230,6745,9133,65822,269463
592,73,734,94,168,767,1836
744,309,2087,271,399,1935,5001
39840,45,389,12,37,320,803
2029,120,2114,81,101,2291,4707
6380,460,13057,245,153,6584,20499
8336,151,0,79,172,228,630
42941,3740,15659,1060,1004,12684,34147
3604,1156,18985,900,610,7564,29215
20113,13,140,8,61,87,309
1524,769,4069,810,631,10045,16324
8518,81,1752,52,66,1004,2955
9922,4723,38918,3276,5987,28689,81593
916,1472,25709,1202,1803,12378,42564
37804,1058,10673,581,160,29807,42279
36280,12,344,2,29,60,447
39680,886,1177,300,198,764,3325
22661,169,4747,174,213,2519,7822
5862,26,507,22,47,384,986
13375,44,3551,26,54,427,4102
36945,1018,3931,410,2850,7653,15862
2053,79,1435,55,62,1104,2735
10236,13,90,8,69,141,321
36344,268,1316,162,133,3882,5761
79,12002,161543,10191,14235,62021,259992
10674,11,496,3,27,121,658
32858,4,221,2,20,38,285
5213,325,1922,227,176,1339,3989
40436,18090,74043,4048,18605,39275,154061
34725,224,373,101,203,2906,3807
10647,2190,55026,1586,979,22188,81969
41739,2,69,1,10,15,97
35701,71,0,40,37,51,199
235,137295,4,64016,42123,56566,300004
280,201,683,297,384,1013,2578
35154,5,18,1,36,30,90
13159,1001,1700,879,1369,3623,8572
31715,1981,72358,701,508,17889,93437
40468,2,78,2,10,22,114
30971,13,80,3,39,71,206
50740,19,819,3,1,108,950
49776,0,1,0,0,9382,9383
44571,15,47,11,21,120,214
34745,3211,9409,2218,2253,12998,30089
7807,39,416,13,59,313,840
37212,6,119,1,11,35,172
3116,88,1054,66,133,434,1775
35155,6,14,2,34,42,98
37355,15,632,7,16,118,788
1710,1550,23786,1818,2594,5089,34837
3834,25,284,20,90,180,599
49110,836,3539,178,229,3900,8682
42765,4,17,5,13,38,77
38668,29030,245407,10782,10902,119615,415736
48969,7,108,3,10,27,155
36092,9,264,1,25,45,344
49841,54,77,5,35,103,274
16608,109,17805,38,155,1058,19165
36616,1133,52904,522,600,21415,76574
18309,11,113,6,73,87,290
30337,8,285,5,28,56,382
9883,545,1267,550,517,2559,5438
41431,3,154,2,10,34,203
38865,379,2187,187,175,909,3837
32783,6,184,4,19,41,254
2090,94,1470,83,89,1453,3189
29151,13,85,5,39,93,235
49784,1,1,0,0,26384,26386
39530,1620,7505,562,397,2052,12136
39901,2,119,0,13,24,158
43610,0,7,1,8,10,26
1865,382,2423,393,642,3606,7446
5292,104,604,80,146,1098,2032
30443,15,139,4,54,83,295
29003,14,50,4,55,115,238
25303,1510,96888,700,394,16889,116381
27417,690,27017,270,333,7177,35487
32666,11,116,4,45,78,254
43649,0,16,1,4,8,29
9006,365,1931,213,185,1529,4223
36821,7,79,3,19,31,139
38025,53,0,25,72,152,302
14515,4999,29730,4182,7829,31124,77864
10218,2557,164701,873,827,24525,193483
33199,18,64,5,65,117,269
38987,46,538,28,55,495,1162
42754,14,223,6,29,73,345
21845,5633,38015,3559,7381,30909,85497
3309,150,1187,98,112,662,2209
707,57,2243,91,58,1110,3559
3391,332,396,257,365,1799,3149
35520,14,56,4,42,95,211
21393,437,2330,256,173,1111,4307
34222,64,155,20,75,508,822
5662,35,999,13,62,267,1376
3419,318,7921,199,128,3060,11626
35424,357,2248,213,125,7680,10623
35067,6162,22621,3334,2935,14403,49455
9806,297,672,99,198,1894,3160
36569,334,1949,163,175,2919,5540
4494,233,2444,165,136,834,3812
22481,13,193,6,45,105,362
37267,5,46,8,33,70,162
43322,1,4,0,5,18,28
3888,532,5832,296,247,1734,8641
44044,3536,12382,846,1481,14621,32866
30740,5408,39298,4034,7796,21259,77795
16718,99,1469,81,113,1655,3417
5494,330,2239,323,289,3166,6347
49069,1,9,0,12,19,41
38118,5,97,4,49,38,193
42519,1033,23227,322,114,8821,33517
49806,40,11,8,14,273,346
33091,4308,45502,2019,1910,32132,85871
1698,12395,146969,10112,7548,111168,288192
36836,52,1551,48,91,736,2478
50925,82,0,3,10,67,162
34447,1731,19273,748,462,8978,31192
30943,18,185,7,74,312,596
34134,65713,999556,16894,25131,250471,1357765
4397,20,909,10,52,139,1130
39152,2,11,2,33,27,75
7900,47,626,17,64,407,1161
39192,7,40,3,29,61,140
1706,405,4063,447,429,3968,9312
1047,438,21490,172,106,7967,30173
38745,0,0,0,0,3484,3484
2063,80,1382,50,56,997,2565
3671,48,717,42,58,648,1513
32420,7,55,2,48,26,138
36374,6,103,2,20,26,157
36198,4212,25817,1210,4855,18801,54895
4071,69,1426,61,79,1148,2783
26267,11,47,5,39,105,207
24877,16,152,11,46,136,361
23289,41994,564724,23005,20452,169251,819426
47058,1,6,0,11,17,35
40023,1885,3242,686,355,1897,8065
43407,0,9,2,4,10,25
24179,18,883,6,17,83,1007
5197,68,623,53,119,649,1512
4026,391,73670,250,251,4067,78629
43262,0,13,2,9,11,35
46827,1,6,0,11,17,35
12591,41,887,41,75,799,1843
1039,105,2080,73,73,1204,3535
3875,53,688,54,116,447,1358
32376,48,1079,36,51,518,1732
10513,50,2136,25,98,372,2681
42276,2,77,2,8,34,123
16706,9891,235761,5369,4770,53594,309385
34547,6940,21748,3668,7265,27527,67148
1624,95,1854,83,73,1516,3621
10629,136,2593,79,82,2825,5715
33350,2950,7116,994,1012,22538,34610
5631,33,1024,9,56,207,1329
35538,14,88,4,46,110,262
36820,7,103,0,22,40,172
9335,410,8516,246,265,4305,13742
10568,11380,110392,8554,9619,83200,223145
31121,2120,26649,1196,1302,12131,43398
36905,16,41,4,46,110,217
2319,56,1946,49,39,978,3068
4879,3372,15867,3189,3108,31728,57264
2261,193,2051,98,136,2241,4719
8133,120,3865,65,115,1608,5773
941,1743,11665,1201,1229,13648,29486
39806,9035,21785,4393,6248,25019,66480
29709,8,54,6,45,62,175
1458,136,890,115,189,1394,2724
3048,346,2882,200,213,1252,4893
21107,36,407,11,28,233,715
33506,32503,479189,15720,16882,112058,656352
1430,1351,80646,539,353,17349,100238
35642,16,180,9,48,75,328
6164,3878,40479,3033,3600,38557,89547
43491,0,8,2,4,11,25
38046,115,1572,73,79,2612,4451
45904,1,4,0,10,18,33
8773,7,248,4,30,56,345
29807,737,3836,380,265,2015,7233
41397,1379,984,458,243,1086,4150
38135,6,78,2,52,34,172
958,790,7215,976,1088,6831,16900
8800,220,3037,212,145,1555,5169
22643,10,85,6,42,86,229
1074,659,63470,465,395,8453,73442
10685,11,94,8,66,104,283
35611,8,47,5,35,49,144
2340,170,780,96,111,635,1792
5733,146,711,104,138,903,2002
43679,0,4,0,9,11,24
5940,9514,102518,5467,8783,39507,165789
33164,1495,15048,879,790,9879,28091
38689,91,102,24,60,245,522
25299,9,56,3,57,76,201
3402,199,1397,87,124,728,2535
29697,74,1178,51,88,835,2226
30163,5,164,4,29,32,234
882,506,19296,327,235,7330,27694
30997,7,31,1,48,36,123
1002,2289,40429,1389,962,24964,70033
6671,15,188,5,64,133,405
22219,12,63,7,86,87,255
38768,447,19670,220,216,5464,26017
32773,76,0,19,80,131,306
6736,89,4762,84,73,1629,6637
34208,356,2349,124,164,4177,7170
39799,8437,34142,2738,10031,26030,81378
5751,322,10289,179,190,3135,14115
38753,19127,148299,7671,9308,90488,274893
34614,82,1715,52,78,1014,2941
9047,967,48003,546,240,12748,62504
5071,75,388,58,123,383,1027
38913,3,199,2,7,39,250
4682,16,280,7,50,172,525
30151,162,0,39,231,423,855
4199,64,560,64,126,595,1409
23815,15,116,17,80,138,366
34934,23404,201832,9547,20367,94473,349623
32382,91,918,41,73,1012,2135
20145,17,142,6,60,220,445
9646,154,1200,42,79,1396,2871
33035,234,7070,117,91,3647,11159
5712,164,3705,125,203,1432,5629
42463,41,0,8,42,80,171
1553,237,3017,208,153,2917,6532
38254,687,5230,262,460,4570,11209
4590,570,5053,310,260,1903,8096
33282,12,652,5,38,82,789
3944,649,5209,388,291,2235,8772
37916,371,4710,209,138,5093,10521
8751,10,363,3,25,78,479
37566,28,98,11,41,190,368
40602,1425,36434,776,897,10682,50214
19831,25,103,17,63,230,438
841,929,10535,699,1564,9927,23654
50876,2,42,2,1,8,55
37865,40,962,46,85,502,1635
31680,6845,92762,2550,7503,18675,128335
23079,8121,88218,5465,19921,34124,155849
32830,193,361,254,566,1042,2416
15579,46,121,33,70,517,787
5398,103,713,76,92,486,1470
10689,114,1650,91,121,2049,4025
16732,10645,76445,7754,8309,66392,169545
2251,39389,403837,33651,20741,315216,812834
39216,3,200,2,13,40,258
33244,2052,12287,774,2067,10629,27809
6184,91,1172,45,50,956,2314
7028,13,1030,8,44,134,1229
37603,7,116,2,12,27,164
42144,5,32,5,32,39,113
30088,515,0,389,156,848,1908
2942,1272,9972,1387,1318,13275,27224
38981,53,1151,27,66,333,1630
37484,103,234,31,185,574,1127
9023,313,11330,204,204,4361,16412
29223,383,7855,268,317,5165,13988
34766,119,1323,42,63,1327,2874
24573,20,123,24,108,111,386
40485,13003,16262,3129,1779,32924,67097
42344,78,3513,18,35,349,3993
33789,46,71,6,67,144,334
31698,33,200,10,74,103,420
39067,26,251,17,50,691,1035
31400,756,4654,384,329,1969,8092
5493,248,8770,202,135,3129,12484
7625,23,162,10,73,234,502
27561,11,66,2,59,81,219
20959,586,3345,325,234,1520,6010
20889,329,11485,157,89,5953,18013
37009,8,78,3,21,31,141
37493,9,29,9,46,115,208
2428,40,827,13,57,392,1329
3684,41,1760,30,35,918,2784
49483,11171,3652,3367,353,10283,28826
7761,110,924,133,143,909,2219
40464,123,622,41,66,1351,2203
2639,15,205,12,40,120,392
33010,4723,41161,2023,2476,67900,118283
43992,1,24,0,19,22,66
17265,59921,649038,37272,41857,211883,999971
42061,8,42,5,38,43,136
3689,47,359,30,86,305,827
36194,75,1505,28,50,611,2269
42445,15,82,10,37,86,230
2156,2491,77279,1880,4783,5751,92184
31506,9,138,0,25,36,208
22167,11,367,11,31,137,557
49580,65,934,26,44,158,1227
10802,32,236,18,77,242,605
10862,129,3143,112,137,1709,5230
49880,11,532,11,15,129,698
37564,1348,3168,388,659,5862,11425
39572,121,233,50,70,824,1298
33238,31,372,8,40,272,723
17745,1283,6022,640,465,3272,11682
41694,24711,66082,9418,7601,79574,187386
21447,27,111,11,82,201,432
35527,12,107,2,28,63,212
49522,0,0,0,0,791,791
38716,0,0,0,0,4912,4912
2611,173,6355,117,144,2496,9285
38717,0,0,0,0,4036,4036
34795,1356,12319,650,550,3429,18304
39730,5280,22955,2070,2808,18171,51284
25873,33,692,6,36,248,1015
10947,134,2855,128,127,2690,5934
5702,1591,18055,1126,1175,14796,36743
38331,1968,6149,768,3239,10524,22648
48825,9,280,3,6,51,349
34944,3502,156135,1369,537,44324,205867
21073,519,4358,352,281,2588,8098
3219,95,4610,97,61,1579,6442
36418,168,721,80,168,1028,2165
36552,42,63,15,89,182,391
10643,789,21645,431,358,10309,33532
5710,87,2687,57,85,1072,3988
7532,26,419,10,55,203,713
39457,52,184,18,132,191,577
43346,0,8,2,6,10,26
22433,4278,47519,2513,3001,29259,86570
49596,0,1,1,0,47944,47946
10138,15,167,15,78,114,389
3990,33,1506,20,63,356,1978
35175,7,23,0,38,33,101
26141,8,44,8,42,103,205
36579,9,92,1,21,42,165
39781,11,119,1,16,48,195
28171,78608,1105075,33316,36924,185694,1439617
3587,131,1132,99,125,576,2063
10058,13,161,5,66,98,343
3003,52,1850,19,43,846,2810
15963,466,14616,233,141,5685,21141
17777,8386,91691,4234,8920,40954,154185
51083,715,1,32,16,235,999
40250,16,184,19,39,286,544
3269,548,20659,399,454,8688,30748
42822,7444,26888,2002,4629,16810,57773
33498,26,474,6,51,190,747
3526,137,1087,68,102,714,2108
33551,14,192,20,50,139,415
34927,141,203,59,157,1051,1611
3329,233,1010,138,147,1341,2869
5344,45,254,34,113,392,838
38710,818,9121,465,140,7196,17740
11837,6398,72240,3582,6934,34122,123276
2116,2473,59768,2412,4356,6972,75981
2511,79,1128,41,63,1377,2688
3193,168,1251,176,253,1186,3034
21513,527,2935,260,259,1033,5014
15653,13,228,6,35,81,363
5501,86,1437,79,160,1149,2911
35027,7,18,1,36,36,98
46569,2,0,0,0,39528,39530
7629,18,58,6,62,92,236
1043,326,10823,287,266,5738,17440
28569,8,38,2,47,44,139
12419,736,24595,482,458,10048,36319
33106,209,3502,106,115,2717,6649
6061,150,950,72,99,1523,2794
35540,5855,30291,2562,5196,29415,73319
48035,1,3,1,10,15,30
32171,3798,17455,1882,5731,21779,50645
7311,13205,356705,5714,4450,169663,549737
1768,80,1649,65,77,812,2683
39348,1,127,0,11,29,168
33870,10,105,2,33,55,205
8465,1213,37093,625,579,7603,47113
43309,4,13,0,13,22,52
36393,7,83,0,15,25,130
48952,26,336,10,18,248,638
38067,164,912,81,126,1620,2903
33434,224,375,129,492,834,2054
32087,17,216,12,71,345,661
28369,33,356,30,60,354,833
39252,10,264,5,17,77,373
35835,3209,11981,1389,5343,15823,37745
21671,417,4683,385,656,2195,8336
44147,0,11,0,14,12,37
34318,160,3008,95,103,2020,5386
23585,16,183,8,54,153,414
50248,0,0,0,0,3036,3036
529,3302,42869,3335,3993,36072,89571
1557,3264,24003,2611,2412,19814,52104
6741,103,2934,53,81,1476,4647
33064,2790,5948,1046,539,9672,19995
38881,89,74,34,180,1284,1661
42672,1,70,1,9,14,95
10106,1173,7497,562,443,3234,12909
7459,21,136,11,40,145,353
51005,2,40,0,1,9,52
50079,1,67,0,3,12,83
3539,140,959,86,120,593,1898
3007,96,3480,54,134,1372,5136
6895,7936,85131,5168,6756,50945,155936
39626,1,5,2,35,25,68
6122,395,3923,236,235,1547,6336
38805,6,119,3,30,53,211
35855,0,0,0,0,1216,1216
26219,8,31,2,51,49,141
19535,22,103,17,97,172,411
3392,272,18033,161,155,3374,21995
35608,4876,148564,1875,965,63251,219531
17725,407,23945,286,179,4592,29409
3763,44,414,29,41,440,968
26023,1184,38358,470,286,12033,52331
49020,284,2674,158,139,935,4190
9818,12,138,5,47,78,280
47591,3952,13757,800,1598,14050,34157
43258,0,8,1,7,14,30
1978,151,5670,88,65,3070,9044
27723,17,108,10,58,138,331
12471,5123,48643,4262,5457,26521,90006
37577,121,890,102,79,1905,3097
31283,327,11909,128,193,3094,15651
35139,19,293,13,57,154,536
37703,309,1984,210,174,8157,10834
2680,361,21357,281,283,4338,26620
5016,65,2324,33,52,1010,3484
12905,39,444,27,38,487,1035
919,657,4577,542,755,6455,12986
16696,17,162,18,87,154,438
27651,30,200,28,55,380,693
30235,10,61,1,30,50,152
44014,3,9,0,12,19,43
38769,5,136,4,18,124,287
48070,0,4,0,8,14,26
14231,23,806,16,50,347,1242
29809,962,8255,469,409,2560,12655
50422,3,60,0,4,17,84
6794,193,5197,140,93,3024,8647
33512,80,944,67,121,1236,2448
49828,0,0,0,0,1168,1168
39686,3,17,1,20,32,73
2198,363,18232,311,201,4927,24034
28669,1508,6409,925,961,4968,14771
17719,23,365,9,54,246,697
31560,599,9030,356,372,3522,13879
48633,0,0,0,0,4623,4623
40366,4,107,2,9,22,144
50218,9,230,3,6,38,286
38001,17,82,9,51,186,345
1236,150,873,192,236,889,2340
1568,4003,28458,2871,3945,21312,60589
2583,78,2335,48,68,1074,3603
1191,233,8127,211,157,2101,10829
37284,5,56,6,45,182,294
29851,9,68,5,38,50,170
51020,0,0,0,0,1125,1125
48365,319,0,118,237,777,1451
8812,74,346,50,117,1093,1680
4614,36,341,18,88,286,769
38390,3368,16099,1624,4790,15095,40976
9745,551,18122,294,230,8287,27484
28907,31361,511221,13019,19151,123769,698521
9333,160,5041,85,82,2271,7639
29743,10,66,11,34,57,178
37072,6,88,1,21,32,148
25169,71,517,56,76,983,1703
42737,25,163,10,21,298,517
42319,72,106,22,60,529,789
539,1814,30380,920,691,12989,46794
28557,9,58,1,54,43,165
39610,276,7229,141,98,6146,13890
10716,515,23858,286,157,7820,32636
36749,67,93,32,53,1491,1736
11789,9,269,6,46,131,461
43572,0,3,2,7,11,23
28169,743,3008,316,336,1492,5895
11799,31,845,12,52,390,1330
2757,103,683,79,152,807,1824
1856,139,4001,142,139,1692,6113
22427,9,356,3,37,56,461
36162,159,1598,80,67,1443,3347
9339,13,73,8,61,149,304
43347,0,10,2,6,10,28
11749,614,2299,331,260,1795,5299
482,10581,141211,10849,14682,12589,189912
12863,470,4241,410,566,2307,7994
4150,47,1391,35,57,803,2333
6889,42,282,34,125,365,848
29937,30,199,16,68,242,555
39589,214,185,91,88,1407,1985
43780,9,31,5,19,470,534
38677,270,781,99,136,2072,3358
518,400,2260,382,402,3480,6924
1206,155,2962,99,84,3646,6946
3064,76,637,66,136,828,1743
5157,76,773,49,103,1195,2196
17387,34,455,30,106,213,838
38321,3,98,2,15,22,140
4763,667,5076,384,335,2099,8561
4419,77,1199,55,94,1123,2548
39097,3,147,2,9,29,190
4586,48,997,59,177,283,1564
49098,50,127,21,39,247,484
13249,83,1487,74,80,1521,3245
31389,1336,78063,637,249,15406,95691
3595,125,852,72,80,1271,2400
47794,734,0,173,60,1476,2443
39659,90,1,69,53,310,523
31763,1505,39852,829,667,22792,65645
3442,145,1131,81,100,718,2175
39202,4,105,1,11,25,146
31690,14,45,5,44,107,215
28221,4824,32253,2933,5543,29833,75386
32621,11,66,3,41,64,185
30178,54,664,39,93,719,1569
30046,5,213,3,27,52,300
30659,18,515,7,32,130,702
22295,143,1925,74,84,2150,4376
37073,8,91,2,16,32,149
23023,80,2994,59,112,1030,4275
1098,430,5039,451,765,2791,9476
45080,0,6,0,9,8,23
37045,583,6224,227,213,5062,12309
38863,3,182,2,13,45,245
3164,34,137,20,59,220,470
2044,1107,3875,888,617,5695,12182
38720,117,2641,73,73,2347,5251
45662,1,7,0,10,19,37
3672,68,1415,74,159,685,2401
16994,19,104,4,47,116,290
38220,142,1042,35,74,721,2014
38854,32,298,23,36,557,946
5036,65,1056,49,54,741,1965
45615,2,122,1,11,22,158
43293,5,113,2,6,21,147
39188,1733,8277,445,583,6761,17799
21437,3902,49502,2158,4108,20345,80015
49956,5,15,3,19,50,92
1044,127,4641,88,104,2466,7426
6867,981,27061,673,851,8277,37843
31790,4338,21595,2962,11756,15682,56333
37195,5,109,2,27,31,174
1443,188,2689,107,125,2530,5639
6305,42,1501,29,40,783,2395
9878,24,206,13,54,210,507
3342,8737,81736,5811,5080,65592,166956
36582,8,133,0,25,49,215
5830,85,1932,72,210,321,2620
24911,686,2869,337,251,1524,5667
6280,988,21640,369,351,4633,27981
8146,53,450,34,58,438,1033
18683,32,165,19,55,324,595
35125,7,72,8,47,84,218
5401,148,972,90,103,577,1890
1913,1815,21123,1191,856,14772,39757
34302,96,1570,57,117,1181,3021
9392,25,310,10,65,227,637
42279,4,75,2,10,30,121
38555,31542,226144,8178,11331,75767,352962
38970,8,226,5,22,83,344
21879,1012,41835,695,864,15109,59515
45425,19412,4,673,1491,16238,37818
25943,395,3014,174,209,4525,8317
42391,3134,6156,918,729,7560,18497
6797,13,548,12,37,166,776
932,146,5457,79,58,1796,7536
31233,447,1714,164,382,2703,5410
161,2374,28037,2480,2280,18760,53931
32763,9,271,4,18,64,366
10775,149,2269,125,125,2499,5167
3567,92,608,43,84,358,1185
10217,502,2605,341,901,3553,7902
50553,0,0,0,0,948,948
1357,452,7284,259,234,4837,13066
30450,26,396,31,69,403,925
22293,16,300,8,30,126,480
3076,317,15123,278,206,5404,21328
32215,2191,95243,833,583,17157,116007
1476,156,4091,124,89,1991,6451
42008,2,24,6,22,28,82
25537,7410,248742,2215,983,113210,372560
11853,78,3010,95,124,1682,4989
30907,26,1638,4,30,201,1899
8632,73,594,59,102,1388,2216
41204,74,1444,56,66,1095,2735
39409,2,13,2,32,32,81
6346,45,1282,22,50,473,1872
45759,1,5,0,10,19,35
2193,139,2035,100,152,2224,4650
11757,96138,2299509,31734,111515,143845,2682741
2138,323,2421,233,239,2783,5999
39082,2,39,1,35,30,107
40748,327182,1165953,33126,16689,177444,1720394
5907,100,816,67,85,1168,2236
27851,9,45,2,52,67,175
36022,460,3875,159,311,1861,6666
39322,7,174,1,11,50,243
2151,138,4186,156,316,962,5758
31892,26,35,9,43,220,333
27437,15,209,4,36,109,373
35262,3900,135176,1063,1605,23834,165578
1126,543,3635,649,536,6708,12071
48624,0,0,0,0,7657,7657
38646,28,142,17,69,538,794
5753,101,3662,67,115,1534,5479
38158,6,161,4,28,63,262
5263,9,589,4,22,128,752
9931,97,1464,55,65,1704,3385
35401,7,242,2,33,67,351
37011,7,117,1,17,31,173
18939,14,96,10,78,90,288
48333,5,9,4,18,23,59
32752,11,123,1,16,31,182
40430,8,162,1,28,40,239
9331,6467,76425,5421,7522,33535,129370
48754,14,42,9,33,120,218
2767,110,1921,76,107,2706,4920
276,2289,32603,1962,1898,18697,57449
554,970,12714,886,1238,6788,22596
11491,2196,31460,1160,2436,13216,50468
35757,2978,31940,876,1377,14610,51781
11179,7305,122097,3860,5195,39875,178332
5646,111,748,69,105,537,1570
35694,115,0,40,148,140,443
44587,4,46,4,11,64,129
7695,328,58187,233,225,4395,63368
7103,1059,7919,1064,2607,5859,18508
32316,73,484,31,56,735,1379
2873,681,13482,341,332,2715,17551
10392,491,3593,253,252,1570,6159
50488,372,6,117,35,864,1394
34719,6,233,3,24,45,311
4480,279,1009,152,130,898,2468
23621,27,161,10,38,260,496
2593,10712,212476,4005,1745,148931,377869
1743,125,2070,187,600,1154,4136
44390,0,0,0,0,1619,1619
32214,3410,17118,2150,5371,14245,42294
34887,9,314,3,40,98,464
49060,13,325,8,31,236,613
33449,14,419,5,31,110,579
21511,11838,103634,7287,13504,66553,202816
1556,730,8290,467,439,9109,19035
2150,1938,12011,1503,879,5500,21831
10987,18,142,14,70,142,386
30666,9,240,7,30,73,359
13825,39,92,14,61,115,321
27829,12153,65302,7093,13793,43034,141375
34859,8,131,2,10,31,182
34151,58,88,28,79,1114,1367
1780,644,6445,358,328,2480,10255
39869,3,87,1,11,17,119
2485,40,1000,43,75,591,1749
40632,0,0,0,0,2616,2616
4458,18,2211,18,42,504,2793
29825,19,169,3,48,142,381
44233,0,0,0,0,302,302
11681,13,43,5,52,85,198
41468,8146,113091,2499,2314,57703,183753
43503,0,11,1,5,9,26
8143,14,53,9,73,129,278
30625,68,936,45,64,878,1991
3326,317,10624,162,116,7807,19026
2653,24,1042,24,73,386,1549
765,45,1320,54,52,627,2098
49518,140,55,50,20,3009,3274
6836,25,765,12,55,160,1017
22489,18,242,4,46,100,410
3417,202,2627,180,263,1851,5123
31471,153,358,73,240,299,1123
46118,6475,9983,2372,5693,17413,41936
5978,462,24413,250,135,6224,31484
21595,95,1636,66,136,1312,3245
18411,2829,27423,2179,3245,17748,53424
35777,780,8283,505,506,2633,12707
4164,188,1145,113,116,1164,2726
18273,17,176,8,37,117,355
38251,872,3952,392,1714,7302,14232
36922,50,1388,23,47,383,1891
333,259,2618,250,240,1874,5241
37684,35,1361,11,28,608,2043
7024,16,1368,10,48,179,1621
35978,8,145,0,11,34,198
9866,28,171,15,57,474,745
22359,1546,6297,1414,2544,15209,27010
872,1588,6732,1513,1331,16138,27302
7540,113,3296,90,81,1357,4937
4701,582,2292,273,258,1368,4773
559,129,4255,117,86,2338,6925
31401,743,3856,384,325,2041,7349
3597,58,1400,29,62,704,2253
36073,22,98,13,142,149,424
44942,9980,115428,2529,9638,38098,175673
50581,154,0,3,15,60,232
36563,35335,277073,11912,11095,106807,442222
31517,28,200,24,110,320,682
9547,120,3629,64,130,832,4775
32252,6,38,2,50,42,138
29812,12,204,6,59,121,402
3631,70,934,50,157,508,1719
49735,18,64,13,18,236,349
30412,271,862,139,206,1349,2827
36225,1631,10180,675,476,3667,16629
32894,35,3152,13,66,259,3525
34006,2577,1183,1027,739,20148,25674
44156,0,11,0,16,10,37
39024,599,2899,98,178,1387,5161
44165,1,8,0,13,15,37
39885,21,267,11,34,216,549
32472,9,52,2,51,28,142
45567,303,1604,186,241,2875,5209
10552,303,2769,186,182,984,4424
10584,21,818,13,41,213,1106
5025,249,2679,117,120,2886,6051
19971,20,187,6,53,211,477
908,916,47476,856,488,16439,66175
41023,8,275,4,10,30,327
17371,669,7889,276,486,2071,11391
6166,9160,110242,5437,8676,47377,180892
7500,14,104,13,91,113,335
42875,30,0,20,22,119,191
9291,33,772,8,53,257,1123
40707,28,90,6,33,206,363
21765,11,173,8,67,97,356
37099,8,85,6,52,44,195
35588,4,105,1,16,23,149
40106,8,171,2,15,36,232
35456,4,124,1,13,32,174
38427,13,36,9,84,73,215
42950,182,329,44,63,691,1309
21467,16,122,8,62,112,320
4692,84,619,57,81,405,1246
2119,89,3433,68,114,903,4607
476,1481,28598,1490,1632,12930,46131
31505,19,306,6,33,170,534
20087,26,103,9,59,152,349
44151,0,11,1,16,12,40
39793,11,540,8,15,114,688
2195,214,1457,153,122,820,2766
40151,675,1892,214,254,2349,5384
23303,16,178,5,41,186,426
40249,242,70,17,117,515,961
39018,12,454,3,20,111,600
34382,32434,264352,13105,37021,93030,439942
5742,52,1198,27,60,585,1922
25089,14,149,7,71,142,383
43735,7143,2,333,1382,7313,16173
3771,1086,6335,559,453,3426,11859
28637,17,790,17,42,212,1078
5136,42,651,39,47,761,1540
36896,8093,521601,1818,1299,84963,617774
30829,232,5466,156,201,3074,9129
32555,2495,15222,1408,2472,15110,36707
33630,47,119,19,61,392,638
2278,38,1164,33,45,578,1858
36102,6,211,6,15,47,285
2705,378,6986,270,552,1489,9675
41489,7,97,0,18,33,155
10659,530,39198,388,282,7251,47649
3667,7219,80837,4950,9509,55175,157690
23273,98269,1355691,50333,45688,320218,1870199
7148,8409,134134,4034,6862,41821,195260
39851,66,47,23,40,745,921
2038,297,1408,246,224,1927,4102
17141,55,219,37,100,673,1084
48589,14,67,6,28,94,209
1633,496,3422,281,314,1992,6505
1401,1188,18417,717,654,3801,24777
39975,15,835,8,12,91,961
17211,72,205,48,91,520,936
526,571,6493,402,371,8674,16511
38843,7563,40891,1614,6747,20737,77552
26009,7,114,3,33,51,208
40626,2,79,1,11,17,110
5649,124,622,73,106,488,1413
50021,442,550,94,374,1019,2479
31691,12,86,8,49,67,222
25969,17,213,6,27,104,367
35101,6,19,1,38,33,97
34394,151,1936,84,107,2351,4629
35949,262,6527,102,113,3396,10400
42619,3,94,2,6,18,123
40686,7,411,5,10,50,483
4729,143,832,65,103,510,1653
31797,1192,12308,534,327,9114,23475
33417,3643,58841,1379,2179,13340,79382
7674,29083,324106,22640,18703,164711,559243
40073,185,717,82,76,2047,3107
40215,1577,55964,508,292,8470,66811
21943,13,117,3,62,73,268
40334,171,2796,171,151,2571,5860
13731,209,5116,130,148,3500,9103
9627,52,468,50,107,650,1327
10245,17,78,5,62,196,358
40564,7,479,4,10,59,559
40942,728,5340,153,165,2223,8609
37948,94,898,41,82,457,1572
40903,13,120,3,9,18,163
90,6739,102920,6515,4814,24289,145277
3486,187,783,166,167,1312,2615
8752,9,225,5,30,53,322
35319,32,51,16,111,218,428
34881,22693,288703,9259,22376,82251,425282
15539,567,3950,300,257,1500,6574
40752,12858,22889,4532,7080,34804,82163
1078,264,23531,241,176,5333,29545
11841,63,460,31,91,489,1134
2211,49,3378,28,45,735,4235
28093,22,805,10,42,165,1044
37492,1055,57447,555,316,26154,85527
19497,11,70,3,47,80,211
41318,3,155,5,14,35,212
1184,700,7765,881,843,5037,15226
36730,17,488,22,52,226,805
2043,1080,7565,1108,1087,6386,17226
43511,0,8,1,6,9,24
29910,74,250,24,87,601,1036
384,11210,200863,8114,15729,85765,321681
25075,18,101,7,58,144,328
23645,8,61,4,43,65,181
35106,11,42,2,47,47,149
38882,42,123,26,51,3659,3901
5249,82,335,80,109,428,1034
35312,44,0,19,70,103,236
9270,74,323,44,81,326,848
48320,2,11,4,11,26,54
19495,44,108,22,45,295,514
10156,4346,41300,2793,5655,19857,73951
1152,354,5664,257,175,3208,9658
37424,154,1752,58,131,1204,3299
12361,46,589,26,129,335,1125
1255,188,11530,138,121,2534,14511
6884,936,40166,561,321,14091,56075
42690,1,60,2,5,13,81
37377,1316,70399,534,409,19079,91737
11065,838,4693,423,306,2074,8334
3371,883,9503,665,310,9620,20981
35974,11,217,2,13,46,289
5628,43,304,41,126,306,820
30405,9,275,2,32,46,364
42215,3,14,0,15,35,67
38284,249,354,127,372,1380,2482
40905,3,93,2,9,20,127
32598,10,39,1,37,45,132
31972,14,320,4,29,96,463
11349,1035,4707,452,407,2314,8915
27787,19440,494337,9858,11954,74449,610038
50710,0,0,0,0,8688,8688
41587,250563,349849,30652,19452,201182,851698
40223,7,66,4,49,88,214
43449,0,4,2,8,12,26
28351,86,5459,26,57,829,6457
36360,9,125,4,21,35,194
21101,11,67,3,43,89,213
8220,31,243,21,100,188,583
9282,39,328,17,91,355,830
14741,47138,852634,27015,29720,228365,1184872
6593,8,118,10,49,128,313
9264,39,540,24,51,358,1012
36372,7,130,0,19,22,178
50631,4,0,11,3,99038,99056
22123,2908,44999,1316,2471,19686,71380
23855,17,119,12,46,180,374
50380,0,0,0,0,4116,4116
34960,34,98,17,28,283,460
32010,17,132,7,48,107,311
35535,7,99,1,17,26,150
14941,1074,25139,786,893,6401,34293
2952,1351,107905,457,324,13617,123654
35935,8,170,2,9,34,223
44071,263,577,27,63,492,1422
397,601,14504,440,295,5861,21701
31300,126,2015,38,45,844,3068
41409,1600,0,106,175,970,2851
37423,36,204,16,48,369,673
4406,74,1304,40,87,657,2162
2111,64,2714,68,79,1092,4017
29755,1828,49545,834,658,25552,78417
4938,1288,40707,820,499,15045,58359
36737,1643,6194,640,424,3234,12135
21679,562,20016,246,170,5962,26956
39479,27,55,15,52,784,933
6271,50,167,28,50,876,1171
38545,10,395,11,37,160,613
22893,53,116,33,79,521,802
50664,0,0,0,0,26577,26577
39475,7,157,2,12,31,209
34179,50,315,10,33,346,754
35138,26,60,8,52,177,323
6878,26,1552,14,63,220,1875
36016,14,70,11,42,73,210
24839,23,106,10,47,144,330
25835,29635,144324,21637,14697,191046,401339
10113,27,136,18,54,223,458
43548,0,6,1,7,10,24
14989,557,1195,478,905,1907,5042
37985,2107,81340,915,573,8624,93559
1145,614,3121,526,549,7909,12719
32901,34260,441364,14562,43278,97173,630637
35932,260,2690,87,55,2767,5859
1724,376,1070,401,579,3462,5888
45698,2,11,0,13,21,47
33713,188,4027,86,65,1837,6203
24347,149,7210,93,118,1666,9236
43333,0,4,1,12,10,27
40670,3,44,4,28,43,122
32644,9,224,0,34,62,329
5689,40,379,31,65,635,1150
40363,6,187,4,12,30,239
1338,197,3254,91,100,2616,6258
28963,49,504,19,42,584,1198
45534,1,13,0,9,16,39
18047,20,336,9,38,133,536
2683,1428,18046,1065,807,12855,34201
39567,4408,15117,1849,6609,14756,42739
32959,586,2274,390,255,550,4055
41519,99,273,49,63,2579,3063
977,176,4999,75,212,1864,7326
49179,0,0,0,0,841,841
39038,8,172,3,20,44,247
142,1669,35085,1932,2140,9949,50775
19261,277,7180,189,292,4592,12530
23051,15,725,8,32,174,954
3496,38,343,17,47,341,786
11097,12,119,6,66,110,313
30752,13,84,7,80,92,276
2030,2484,19281,3055,3026,21098,48944
95,2719,16587,2536,1590,17192,40624
820,29479,61578,17176,6962,157425,272620
36640,16,174,3,15,111,319
7398,24,195,15,72,274,580
10723,77,517,36,60,1190,1880
6372,2003,123017,1215,542,31440,158217
3350,351,2111,177,205,972,3816
37934,55,342,31,48,574,1050
43250,0,13,2,10,10,35
3508,1302,14786,990,513,16621,34212
1248,191,5179,117,113,2881,8481
38578,1417,2850,635,674,3409,8985
35074,16,86,11,35,170,318
5688,350,865,338,301,1977,3831
18549,90,1602,61,102,1240,3095
4068,89,336,57,110,1090,1682
39691,2,19,3,19,31,74
49215,568,877,168,153,1798,3564
1232,164,4981,151,165,2062,7523
8704,12,419,2,39,85,557
28617,12924,105547,8219,18028,66281,210999
1237,424,21374,316,218,5779,28111
24441,22,129,4,55,73,283
313,78,1943,61,105,1372,3559
23383,809,48202,368,176,9534,59089
2562,1361,12288,1457,1554,13261,29921
14991,1613,12473,803,597,4720,20206
14181,40,449,14,53,352,908
35266,19,80,10,47,163,319
1124,165,5372,109,79,2267,7992
3641,249,4534,157,241,2449,7630
3618,152,4023,238,168,1402,5983
33882,17,179,12,47,255,510
35674,7,60,2,25,59,153
50239,2,27,0,2,5,36
8514,592,50838,342,222,7565,59559
13137,176,3308,143,123,2070,5820
49303,0,0,0,0,32731,32731
2391,212,4339,305,1297,1771,7924
30125,14,94,3,46,96,253
51096,0,0,0,0,14507,14507
1050,5412,35358,7198,10148,24934,83050
35240,13489,81923,6906,7815,70701,180834
452,908,78844,579,256,11446,92033
40974,10034,66474,2640,5831,26268,111247
29609,14,279,1,34,73,401
40356,5,1,4,1,406096,406107
15719,287,5314,210,198,3365,9374
7258,29,728,12,49,299,1117
6628,114,2918,74,106,1486,4698
42109,8,39,7,20,27,101
14373,559,11520,226,183,7001,19489
29655,7,179,4,37,67,294
13449,20,148,13,56,165,402
35997,3625,13579,1592,6638,12487,37921
1841,108,5878,83,67,1457,7593
40761,436,3383,214,226,3868,8127
3287,573,24916,174,582,6532,32777
39251,2,136,0,13,32,183
42571,4801,25754,1214,3625,21741,57135
31585,10,172,7,28,88,305
29944,13,810,9,31,105,968
7308,66,961,48,90,1121,2286
43512,0,9,1,7,10,27
30292,110,1248,70,57,1228,2713
42663,1,68,1,7,13,90
1930,121,3787,87,122,1686,5803
66,15779,154438,17201,14052,89380,290850
42329,1,22,3,19,35,80
32542,49910,398446,31503,43753,140159,663771
49574,0,0,0,0,1344,1344
42940,3350,49483,503,301,13306,66943
26359,233,6650,155,113,4491,11642
204,1194,15703,1034,1692,6692,26315
49263,1563,5805,303,414,5887,13972
39126,3,24,1,29,32,89
75,2396,17387,1960,2126,19892,43761
8145,45,454,37,64,443,1043
49326,5,9,0,15,27,56
27613,451,4601,398,325,3235,9010
4042,107,1596,60,68,1073,2904
1899,181,1030,147,198,1328,2884
39105,11,138,8,32,171,360
2088,60,1198,40,56,978,2332
36763,8,204,2,14,48,276
22655,726,2435,332,283,1423,5199
40035,30,383,16,41,485,955
40928,3,105,4,9,18,139
48968,3,79,4,8,20,114
39145,2,9,2,28,32,73
42854,7,115,5,7,20,154
2446,694,4817,335,310,1803,7959
4417,11,85,11,55,112,274
14355,3234,31601,1604,1903,32113,70455
48702,1,0,0,0,10470,10471
5763,71,568,56,118,872,1685
1885,117,513,117,244,873,1864
38409,3042,34796,1052,975,16252,56117
9988,701,8514,332,318,6218,16083
2086,45,399,28,52,504,1028
30381,198,4195,90,91,1637,6211
740,6177,109123,3979,2085,17348,138712
39370,5,80,4,30,66,185
40262,3969,195050,1134,555,35953,236661
684,192,3020,143,186,1692,5233
48455,705,0,96,129,843,1773
1847,173,19926,196,84,2728,23107
28207,130,3149,101,135,1067,4582
31539,66,112,35,136,853,1202
45858,1,3,0,11,19,34
1563,827,20680,847,629,6501,29484
38917,2141,16615,566,708,10095,30125
19947,31,158,24,94,248,555
39841,7,156,2,15,63,243
42908,4,86,1,4,17,112
40167,296,1624,127,250,1079,3376
16051,1677,23018,1106,1225,8328,35354
9861,68,1099,63,75,1115,2420
8171,381,13442,242,332,4623,19020
32485,1840,111302,649,428,17699,131918
545,157,1220,168,293,1398,3236
2563,588,20500,517,333,12340,34278
22221,18,304,19,111,140,592
3178,65,601,45,55,771,1537
3505,103,584,89,130,998,1904
7262,522,2799,284,250,1896,5751
9107,3237,65908,3314,6436,8552,87447
31508,6,30,2,43,33,114
12995,683,4583,357,356,2077,8056
50415,23,127,11,12,178,351
36382,7,131,3,26,25,192
30340,7,318,2,26,60,413
2430,205,1547,122,163,928,2965
8348,352,14694,308,265,5861,21480
31730,24,78,7,47,152,308
37544,5,178,1,15,76,275
42292,2,9,1,11,23,46
42439,10,203,8,11,61,293
1866,152,1070,63,86,1700,3071
48347,6,25,2,16,67,116
26059,247,2044,141,132,782,3346
13993,112,802,77,88,1846,2925
35760,70203,1623813,11952,7697,151401,1865066
31874,9,299,4,52,59,423
21561,12586,119664,6319,7472,73797,219838
7768,1910,19711,1599,2659,16023,41902
37976,36754,228662,19222,30379,105221,420238
48414,75861,10,1784,2881,55931,136467
22499,9,130,5,44,90,278
115,304,6628,340,368,2844,10484
18095,10739,90708,5664,8750,54381,170242
27837,14,89,6,52,140,301
43569,0,6,1,6,10,23
25241,1596,38696,1020,1619,7884,50815
39696,8,141,4,30,94,277
2530,586,3337,334,451,2358,7066
40327,1035,811,430,563,3254,6093
10575,292,2007,168,174,974,3615
6528,15,82,8,65,194,364
8764,24,361,16,75,135,611
41119,2,22,3,16,26,69
2706,171,4173,117,244,724,5429
11795,20,957,6,32,170,1185
5568,222,1515,131,144,882,2894
34290,1405,3576,768,712,3524,9985
33776,118,426,71,93,1162,1870
41191,34,356,28,49,417,884
19469,790,24551,329,343,8492,34505
43281,0,8,1,11,10,30
38743,6,23,5,37,138,209
7875,482,11248,278,197,5560,17765
39767,54,241,19,51,270,635
40014,60,438,31,52,598,1179
40712,226,2226,102,160,1943,4657
26109,10,33,4,43,59,149
9328,519,4862,301,347,4225,10254
33209,786,7182,294,264,4017,12543
38295,4041,24839,1441,5751,18057,54129
6195,29,116,16,78,257,496
1702,222,910,121,155,1443,2851
40473,238,551,88,537,2863,4277
34119,6,83,2,26,32,149
33668,2003,9312,1059,2664,9153,24191
12441,26,279,9,66,335,715
2450,187,6056,73,189,1344,7849
35423,12,339,4,21,66,442
31244,64,1008,84,150,1388,2694
51071,3,9,2,4,20,38
5277,6877,172055,3201,3030,34466,219629
50498,1,37,0,1,4,43
21089,22,619,8,27,210,886
16866,1389,72584,680,486,20949,96088
14227,40531,692108,22530,21230,156903,933302
32581,13,233,1,23,75,345
30341,9,236,5,34,70,354
39700,8,206,5,12,52,283
40932,77,2458,37,45,975,3592
4444,71,1318,45,185,717,2336
33500,11,142,3,47,77,280
43988,1,26,0,18,22,67
40615,2600,71772,730,455,42319,117876
48604,17,579,7,15,168,786
40853,310,9047,120,118,4375,13970
2228,136,3347,106,208,756,4553
31821,5489,93713,2593,2043,24934,128772
31568,16,619,12,48,189,884
44236,125,1143,31,68,853,2220
35712,17773,129129,7488,20280,59458,234128
30276,117346,2354053,38270,34092,162378,2706139
44152,0,11,1,14,11,37
36170,9,361,5,17,68,460
31553,2126,130326,886,495,24757,158590
30039,322,3075,184,334,991,4906
23407,14,56,3,50,93,216
34060,75,1259,30,76,440,1880
5108,83,632,49,81,380,1225
33727,24,51,11,78,131,295
2751,284,5078,178,173,5890,11603
20557,126,2613,177,257,1687,4860
80,9316,60596,6218,3512,32855,112497
49409,72,1144,21,29,588,1854
37536,5,98,1,15,28,147
43771,0,0,0,0,877,877
332,172,1715,171,219,1351,3628
10937,9049,24887,2993,944,23298,61171
42750,100,119,52,40,2046,2357
19855,3552,35149,2645,7623,13324,62293
50077,2,77,0,2,17,98
40532,12447,46018,5126,7199,43561,114351
10466,31,293,15,47,323,709
19627,15,145,11,49,227,447
15505,127,1074,116,104,842,2263
28355,5,206,2,33,38,284
50206,32,463,2,8,143,648
15541,751,3274,366,298,1746,6435
2571,133,6707,194,662,694,8390
3024,263,1324,316,379,1934,4216
12505,386,21211,258,176,4795,26826
15751,4363,64366,2283,3198,34856,109066
7843,30,613,14,35,372,1064
37920,8036,54725,3043,8254,28875,102933
16552,13,70,5,51,114,253
10703,158,9302,124,135,2095,11814
8772,7,211,8,31,53,310
36323,6,14,3,35,29,87
35140,41,70,11,72,138,332
36577,72,883,25,44,643,1667
196,1975,63520,1557,2259,13663,82974
3463,66,853,49,125,825,1918
37426,8665,46663,4601,10061,46443,116433
27633,3777,98487,1939,944,19226,124373
624,893,10787,565,1229,5056,18530
36618,151,399,36,87,786,1459
50238,1,26,0,1,2,30
36144,7780,23134,3574,6289,27043,67820
39676,175,471,65,133,853,1697
30979,7,34,2,45,37,125
35489,8,35,4,35,48,130
37923,14,638,3,25,145,825
35677,3366,49436,1197,530,54802,109331
33163,32,304,16,54,265,671
34604,1935,11576,557,375,8575,23018
32084,272,1350,127,217,2524,4490
13357,3476,164913,1257,1043,16253,186942
27387,1466,27261,415,346,20526,50014
34694,12,72,4,31,81,200
11981,5082,251070,2303,1220,69927,329602
48862,653,1126,102,275,2286,4442
16395,356,15017,225,182,4393,20173
34233,29,67,8,93,127,324
43384,0,6,0,13,12,31
29832,13,82,9,65,90,259
40502,4,160,2,9,31,206
29467,14,64,4,54,62,198
45525,2,11,1,18,20,52
42616,3,94,1,7,20,125
3566,158,1202,93,118,718,2289
23477,228,2007,175,120,932,3462
10739,407,27212,240,206,6898,34963
9434,322,2072,169,171,996,3730
41006,35839,64233,14648,17003,94965,226688
50141,13,41,8,44,70,176
789,1486,23348,1512,1833,15556,43735
6519,12,124,6,57,124,323
30096,17,165,5,53,86,326
37105,37680,382907,15369,17411,153969,607336
49316,1,1,0,0,18213,18215
10688,47,906,15,38,546,1552
5610,109,406,60,90,460,1125
31788,1403,4949,596,392,2855,10195
35709,24,833,4,26,145,1032
33905,41,1977,18,36,302,2374
34494,14338,42694,9769,13824,53892,134517
49909,1,0,0,0,1101,1102
4565,4142,126324,1680,1089,57019,190254
34103,2709,129191,1111,761,25653,159425
4667,125,3352,110,273,734,4594
4598,17,138,12,98,124,389
5565,49,390,36,89,394,958
449,906,70386,587,281,12349,84509
39704,4,152,4,9,45,214
19467,40,83,20,61,421,625
30463,138,378,66,133,1151,1866
39168,0,0,0,0,6085,6085
5945,886,3663,813,1899,5440,12701
10546,996,3706,443,376,2092,7613
24527,36,555,21,33,314,959
33875,17,173,15,48,200,453
5773,68,553,36,130,388,1175
38339,19,69,25,83,176,372
37601,3664,12442,1499,6465,15156,39226
4476,139,2170,92,91,1792,4284
39349,5,134,3,11,34,187
45761,1,4,0,12,19,36
6992,44,963,32,33,725,1797
8157,36,353,31,56,355,831
30129,14,44,7,51,56,172
1572,284,3302,429,611,2292,6918
35625,32,311,7,40,230,620
6337,543,3268,312,293,1537,5953
36724,62,0,36,68,132,298
27495,13,157,8,60,103,341
37666,15,146,10,69,101,341
33400,8,171,1,19,37,236
43438,21,499,14,24,132,690
38424,10,211,1,23,61,306
49491,1,39,0,6,17,63
33541,154,1571,94,350,962,3131
24169,95,4475,86,117,1515,6288
653,267,5592,312,246,2366,8783
41184,3,25,4,17,26,75
34902,33966,422311,12711,13362,136832,619182
36595,23,781,9,15,113,941
14853,117,4750,57,54,1963,6941
44211,419,2024,174,146,846,3609
39800,832,7342,425,323,2323,11245
29722,82,303,78,189,577,1229
12899,22,97,8,59,212,398
34476,34,83,8,36,199,360
5611,76,471,48,105,407,1107
49163,0,0,0,0,2151,2151
36352,5,85,3,19,21,133
272,4350,42988,5492,5732,43077,101639
40811,5,151,2,7,39,204
35042,11,38,2,35,42,128
33200,10,56,5,58,58,187
29837,47,200,16,59,339,661
1678,1550,13398,2530,2405,9876,29759
26115,13,47,5,45,78,188
17641,2367,145561,949,712,25207,174796
7117,18,561,6,37,263,885
3800,96,778,83,173,649,1779
4822,46,241,34,68,300,689
6848,12,535,6,40,106,699
15409,587,5146,330,275,1803,8141
42454,41,294,17,37,293,682
48110,2,4,0,14,17,37
29768,10,581,4,32,109,736
21085,16007,182941,7769,11711,67656,286084
365,260,14942,134,195,3698,19229
1190,151,12639,91,111,2087,15079
35643,25,130,12,50,90,307
36021,107,219,47,55,801,1229
7285,46,409,51,62,919,1487
4742,45,513,33,94,470,1155
36789,220,2495,123,125,4286,7249
41391,22,1,19,21,39,102
31736,888,11008,445,359,4617,17317
40982,221,3384,111,73,2457,6246
44,7411,163506,3436,2042,76230,252625
15925,57,4712,37,112,528,5446
40556,7,482,4,9,37,539
7092,55,130,18,55,518,776
40365,5,25,3,18,38,89
1495,118,1885,85,94,1707,3889
2252,1474,7635,980,1327,15132,26548
3135,287,4101,97,88,3957,8530
23301,1256,21746,827,489,2976,27294
2684,237,5435,186,284,1993,8135
439,190,4377,163,152,2785,7667
32473,10,111,1,30,27,179
34502,65,392,17,131,369,974
1869,333,12467,285,273,3423,16781
1444,151,2630,149,178,1437,4545
9618,914,32884,436,346,8510,43090
23539,2619,2,1101,1016,5912,10650
34592,8,67,4,39,55,173
9488,607,7173,257,126,26076,34239
3575,13,67,6,58,109,253
10506,106,0,23,215,278,622
41317,53,509,28,36,560,1186
39042,2400,5380,846,556,1949,11131
36254,344,805,146,157,478,1930
32240,227,4230,275,266,3636,8634
41019,10,76,6,42,90,224
5586,72,404,35,99,336,946
43207,19,53,4,38,148,262
10059,11,162,9,69,142,393
50604,67,0,12,11,231,321
38096,21,315,6,23,229,594
8723,34,143,19,66,462,724
9935,663,1891,562,486,3922,7524
48649,1,0,0,0,3195,3196
6331,50,811,41,51,616,1569
37461,7,94,1,15,24,141
2015,69,1257,52,53,891,2322
41520,800,2763,243,339,5119,9264
2325,352,4243,206,228,1432,6461
39163,9,1324,2,17,73,1425
5784,1062,20970,587,721,7647,30987
50510,34,0,8,11,87,140
19517,9,78,3,62,73,225
48053,0,4,0,11,12,27
37272,613,2257,244,168,5825,9107
19363,3876,102756,2420,1220,22441,132713
28305,8,287,4,35,74,408
15895,710,18101,292,201,7609,26913
30921,70,498,47,46,1244,1905
8986,2014,10019,1812,2749,13006,29600
44090,48,444,22,35,281,830
39130,4,26,2,30,34,96
41181,22,990,8,14,155,1189
6235,371,2046,229,182,1402,4230
48956,741,1,46,57,285,1130
1120,568,100386,268,280,4285,105787
1803,116,2773,80,51,1692,4712
30132,470,3143,226,207,1136,5182
860,1556,24278,1812,2538,11102,41286
36918,34,1285,26,49,351,1745
20707,45,2994,28,52,490,3609
36279,8,200,1,22,45,276
8619,333,7030,182,163,3254,10962
8732,11,285,2,31,71,400
28205,1555,1059,886,544,1665,5709
38273,0,0,0,0,4554,4554
34424,5,109,1,10,23,148
43516,0,7,1,7,10,25
8366,79,2522,45,97,678,3421
30298,28,261,10,65,242,606
1264,613,10733,845,946,3787,16924
24859,13,68,6,46,115,248
4604,143,801,80,107,568,1699
37144,11,80,6,46,73,216
43570,0,10,1,6,10,27
42658,85,65,34,71,133,388
685,299,4456,264,326,3107,8452
35023,7,22,2,34,36,101
31057,57,174,35,73,233,572
36954,16,144,2,33,72,267
38820,46,0,29,50,84,209
2894,151,1282,83,144,625,2285
49570,0,0,0,0,874,874
45681,1,6,0,11,16,34
34464,43,427,8,35,287,800
44078,84,78,22,34,237,455
1558,183,2238,103,136,988,3648
22943,15,497,8,28,156,704
25627,14,150,9,99,139,411
11053,45,3878,36,96,573,4628
20987,421,3144,278,181,4901,8925
10219,256,10636,135,141,3136,14304
21599,132,1260,88,83,1271,2834
16123,1525,18984,779,754,10166,32208
2750,15,119,6,53,131,324
48076,0,6,0,12,15,33
38051,28,1038,12,32,305,1415
32935,34007,863923,7178,4550,87693,997351
6303,112,2232,103,244,420,3111
1613,43,1863,23,57,588,2574
26351,8194,56566,6105,10677,41240,122782
28483,6,36,4,42,47,135
3727,78,6034,54,119,671,6956
22595,8,67,5,43,69,192
39244,274,2714,105,207,1523,4823
1800,145,6710,86,59,1470,8470
25883,77,3779,28,34,707,4625
30053,12,475,5,44,176,712
46727,1,4,0,9,18,32
40393,26,0,20,41,98,185
34539,895,4802,450,1334,4958,12439
34371,14,93,5,51,86,249
48045,5,12,1,13,30,61
35329,69,905,37,56,854,1921
49838,15,965,5,11,121,1117
29863,31,495,25,80,620,1251
8718,11,300,5,29,95,440
37687,7,37,2,37,35,118
2101,46,608,15,58,515,1242
39243,8,328,4,16,50,406
6114,23763,154228,18046,13766,141014,350817
36864,11781,80538,4279,7113,45079,148790
36321,6,18,2,36,28,90
39427,1,10,3,30,31,75
41573,2249,7117,582,1067,10044,21059
2797,182,1908,97,93,1646,3926
49778,0,0,0,0,1042,1042
29017,228,2687,148,254,1137,4454
42867,1111,6117,361,460,8622,16671
8317,233,4889,212,164,4489,9987
7627,5119,49992,3101,4858,35166,98236
28045,26,616,10,60,148,860
16405,788,10748,511,1706,4724,18477
25091,10,57,4,54,61,186
37610,4,172,3,14,42,235
43462,0,9,2,5,11,27
27997,66,437,33,53,761,1350
42774,4561,11666,1306,6525,14093,38151
1922,135,3853,102,94,2146,6330
9786,127,2310,117,216,1889,4659
46971,270,5875,85,61,1687,7978
50932,0,0,0,0,683,683
2904,47358,1269162,21478,15081,173011,1526090
30761,7,62,0,32,40,141
15391,1143,14915,416,490,6494,23458
555,268,7099,274,493,2992,11126
38329,11980,428994,3059,1468,110628,556129
42895,4,74,3,11,16,108
39720,59,111,15,40,188,413
906,821,105407,379,285,6710,113602
6862,1282,121664,754,420,19437,143557
31700,11,78,4,62,64,219
10893,1098,25617,505,368,15815,43403
2009,69,1217,43,67,1006,2402
18821,14,130,6,49,108,307
35310,12,118,11,45,85,271
1998,198,5638,159,170,2633,8798
6229,233,275,111,102,1712,2433
40689,3,88,3,9,19,122
14719,102780,1011605,49939,37507,145049,1346880
3838,47,339,36,82,405,909
35747,9,220,1,26,43,299
39225,3,34,4,43,31,115
3841,5827,25234,6403,5140,16526,59130
19999,13,90,9,93,78,283
2188,539,4916,306,283,1908,7952
30977,7,32,1,53,38,131
33203,6971,54459,3522,7620,35116,107688
2349,502,5238,240,491,2145,8616
2685,2188,59366,1412,969,24362,88297
1135,242,7275,164,117,3591,11389
18689,23564,112680,14924,10221,52075,213464
42248,3,90,1,11,45,150
49613,0,0,0,0,2513,2513
28595,95,1149,59,327,321,1951
30012,9,216,4,46,59,334
32946,104,2697,60,71,1539,4471
33734,30,1033,14,46,257,1380
345,2262,19891,1778,1583,24561,50075
47986,0,3,0,10,13,26
48967,4,70,2,3,18,97
4663,145,2430,106,147,1149,3977
18825,14,172,8,44,111,349
39355,8442,48473,2340,2236,27997,89488
37956,7795,103209,3322,4205,34407,152938
1811,113,1789,82,75,1340,3399
8740,1017,63680,413,336,8104,73550
10353,34,125,20,49,416,644
7124,19,188,8,37,181,433
47537,201,76,72,70,1082,1501
2133,87,1411,57,79,1717,3351
2394,372,2441,176,179,1248,4416
17843,168,8054,113,187,1951,10473
4855,49,752,48,49,660,1558
33834,13560,50644,5428,18022,45611,133265
35923,225,2377,128,509,1703,4942
1860,5345,31909,3551,3816,35931,80552
29499,10,52,8,52,52,174
17727,174,1648,182,123,1477,3604
33421,13786,69249,5116,11775,70833,170759
40924,105,3586,54,68,2424,6237
30335,10,243,2,29,58,342
45447,34,26,11,39,112,222
38849,4,124,0,16,41,185
1117,859,164056,264,284,4029,169492
13681,71,672,54,56,741,1594
28583,13,71,6,65,78,233
1378,120,3003,73,83,1494,4773
31898,17,208,12,78,75,390
35696,48,0,21,72,111,252
5043,61,1131,54,58,770,2074
31165,315,3939,216,177,4316,8963
15673,68,4446,29,38,661,5242
39250,45,506,15,63,609,1238
18063,22,336,19,96,351,824
43616,0,11,1,6,8,26
37184,201,1820,61,93,740,2915
21509,17,72,5,62,97,253
21641,63,703,13,35,820,1634
520,169,6244,135,98,3096,9742
36062,11,326,2,21,40,400
1837,249,2400,216,286,2299,5450
25689,1092,10802,460,289,7815,20458
39753,1927,18486,679,274,35190,56556
23011,25,107,13,81,172,398
37507,82,2042,36,70,915,3145
48872,4,59,0,16,33,112
38365,35,48,13,142,153,391
37000,50,878,29,37,402,1396
39288,11,472,1,12,62,558
34192,6,54,1,40,44,145
32953,129,6587,65,96,1195,8072
45718,1,5,0,9,18,33
7364,65,948,49,67,877,2006
38389,615,6157,290,426,4824,12312
44087,1672,29002,528,217,19411,50830
6675,6150,212987,2040,931,93880,315988
29831,399,3607,213,181,5168,9568
8214,30,366,18,49,292,755
42385,0,0,0,0,3342,3342
34864,33,379,23,53,338,826
33390,93,369,36,62,913,1473
2581,8989,139396,6313,4826,41253,200777
37206,2559,16994,1388,2887,14519,38347
47790,58387,191978,3979,7401,71664,333409
3907,639,5695,425,413,6326,13498
17076,26,772,7,60,143,1008
11755,516,8422,247,322,7755,17262
34451,25638,218710,11834,8779,106314,371275
25045,815,21357,600,627,7095,30494
43305,1,6,0,8,12,27
42890,75,113,27,94,187,496
36843,13,63,3,44,79,202
6932,52,976,33,44,714,1819
35313,958,6184,515,1622,6246,15525
32639,11,249,1,31,69,361
48392,199,360,73,71,326,1029
42310,0,0,0,0,24702,24702
29679,9,237,2,38,102,388
21037,41,130,15,62,435,683
38770,464,16540,156,165,5070,22395
3235,61,288,44,91,554,1038
33124,11,221,1,35,41,309
31587,13,206,9,34,147,409
525,859,4388,911,989,9216,16363
24073,27,137,15,60,204,443
30363,14833,264697,6655,9204,47013,342402
3750,634,11525,419,458,6998,20034
32226,12,63,6,49,56,186
30168,49,1928,33,57,606,2673
6828,10,627,4,41,78,760
16247,34,443,14,48,342,881
39239,763,27890,323,454,7690,37120
714,178,1146,218,257,1485,3284
38354,18,129,2,18,68,235
27907,114,2827,55,99,1157,4252
13457,44,40,10,112,99,305
50090,9,185,4,24,97,319
848,65,1623,58,49,949,2744
26209,17,110,12,43,135,317
13185,537,3410,399,688,2005,7039
42346,8,27,5,28,41,109
37941,4,54,2,41,39,140
24835,284,4478,176,387,1543,6868
41495,6,196,3,9,37,251
9344,28,426,23,41,326,844
3411,259,1780,126,171,916,3252
19585,32,184,38,84,130,468
43466,370,3969,170,195,935,5639
8235,106,1079,85,190,772,2232
37669,6,102,1,17,29,155
36729,603,7116,285,406,7322,15732
10827,817,6694,424,342,2800,11077
19,90226,278683,59405,27950,354147,810411
17409,1494,33948,805,835,13818,50900
573,1243,17122,1195,1237,8224,29021
33823,9,43,2,45,59,158
39621,28,223,8,72,227,558
29605,69,100,32,65,231,497
11019,106,7187,148,210,2299,9950
5276,104,439,74,118,725,1460
44254,5,282,2,6,17,312
41250,27,60,10,30,175,302
25839,2914,34701,1568,3161,11792,54136
43578,0,7,1,7,10,25
32174,245,4583,126,103,2856,7913
34472,16,169,4,32,65,286
4104,21,311,16,63,165,576
252,1753,14968,1934,2118,17052,37825
5049,170,997,100,113,713,2093
40208,269,698,85,146,1573,2771
10928,884,25901,583,373,6992,34733
44149,0,11,1,15,12,39
25979,8,145,4,38,60,255
48981,0,0,0,0,2025,2025
21639,8247,27298,4035,5830,9657,55067
1916,258,8652,202,216,3435,12763
443,531,39020,307,212,5133,45203
24789,40,185,10,38,239,512
31878,10,112,3,28,49,202
34695,12,67,2,30,67,178
17947,293,4848,134,121,6927,12323
48346,1,10,1,16,26,54
8229,15,74,8,40,112,249
33115,8,73,2,47,58,188
2417,163,10891,80,153,1759,13046
34481,1023,26809,331,209,8010,36382
602,102,939,108,151,1213,2513
39196,34317,220993,10231,10774,63302,339617
3886,82,3164,42,92,1209,4589
47989,0,5,1,15,14,35
35086,455,2718,266,126,10107,13672
370,375,5595,383,423,3353,10129
38117,2,90,1,42,38,173
2749,42,434,41,93,312,922
48058,1,5,0,11,16,33
37065,9,277,1,39,49,375
2674,51,2657,80,98,770,3656
15583,32836,652960,15818,26740,154874,883228
33889,5333,14147,1982,7602,21391,50455
5994,21,103,11,60,230,425
34227,15,201,4,40,133,393
1325,245,1929,323,475,2939,5911
3930,12,1100,7,39,128,1286
24927,8,64,6,77,81,236
41080,63,108,14,45,202,432
20371,1067,44661,367,475,12905,59475
40836,65,966,77,89,841,2038
36419,0,0,0,0,7996,7996
43769,119,0,56,25,99,299
37721,6,116,1,20,39,182
4782,49,216,39,88,283,675
44144,1,15,0,14,12,42
1480,109,5122,83,74,1551,6939
30251,381,2021,223,768,3281,6674
15897,21,70,10,62,122,285
7109,35,176,24,75,193,503
34249,14,88,10,64,75,251
15819,74,752,59,66,860,1811
2494,4097,61325,2774,3697,20598,92491
19121,37,177,18,73,292,597
9884,250,717,305,359,1595,3226
3451,24,151,10,58,162,405
22161,22,1176,12,36,226,1472
33383,20,41,3,39,80,183
3162,151,1249,160,203,1419,3182
18693,1043,7304,581,408,3158,12494
1578,560,4868,353,482,4498,10761
41638,54,0,14,66,158,292
4039,3493,9840,2784,2555,19287,37959
42224,1870,1436,510,336,1136,5288
43816,0,10,1,5,9,25
42128,54,1274,44,55,439,1866
936,1614,190439,743,603,13756,207155
8577,1600,59736,764,989,8403,71492
3109,167,965,95,126,719,2072
22439,21,233,15,63,191,523
10098,306,4920,249,178,3646,9299
38856,3,116,1,7,23,150
24845,67,43,23,143,216,492
13669,138,1610,65,101,1364,3278
2408,92,3664,66,93,1215,5130
29163,2926,20483,2084,2783,20395,48671
2378,187,1466,125,134,683,2595
1158,100,1551,74,83,1019,2827
318,973,17641,772,1076,7077,27539
12101,77,1772,34,88,1037,3008
13409,1055,15303,880,893,5492,23623
37981,2449,31090,888,406,43265,78098
2678,38,2475,70,92,494,3169
23763,14,155,4,52,105,330
2210,110,13364,59,58,2063,15654
31711,2051,66348,789,580,15576,85344
2052,68,584,37,68,844,1601
40129,658,362,228,670,1948,3866
45654,16,77,8,26,149,276
35499,521,1201,198,144,917,2981
12365,9462,222605,5218,3073,60425,300783
47787,2,0,2,9,16,29
20391,51,1916,47,63,963,3040
40908,42005,144074,8838,11538,84644,291099
978,633,6311,407,344,5380,13075
724,509,16336,222,703,3424,21194
629,253,4476,218,232,3189,8368
48097,117,376,18,47,176,734
43510,0,7,1,5,11,24
19887,15,65,3,58,147,288
45764,1,6,0,10,19,36
22413,11,112,6,56,82,267
177,10138,113445,11950,12757,62880,211170
36294,6,69,2,25,30,132
12175,12034,119747,6025,7532,75378,220716
5521,591,27006,377,240,8246,36460
35099,11,53,1,43,38,146
26303,10,198,10,37,182,437
41782,77,89,49,21,4774,5010
32890,23,103,3,51,115,295
5039,5339,35742,3806,4201,39507,88595
42516,1839,2920,459,1672,4274,11164
25093,9,46,3,57,74,189
33118,497,3502,525,192,2193,6909
659,303,31011,270,178,6128,37890
40005,1643,17069,335,329,5826,25202
39764,302,5498,146,85,7363,13394
35946,3073,206826,998,887,44467,256251
41636,25,166,15,45,154,405
38414,4253,132033,1491,653,64424,202854
18229,9228,81493,7611,10835,64612,173779
920,82,3447,70,57,1271,4927
30052,11,63,4,51,59,188
31268,13,272,7,24,113,429
2406,1766,0,600,1527,3031,6924
37825,18,313,3,33,119,486
13253,54,3864,30,46,725,4719
3764,34,292,29,46,384,785
23249,416,6189,196,156,5285,12242
5307,1667,8657,1492,1950,10242,24008
7811,26,1178,12,42,343,1601
35062,106939,340931,50024,38931,220199,757024
48570,35,45,19,24,198,321
31163,17215,161012,9994,16402,71544,276167
835,334,4101,347,486,3225,8493
42286,1,11,1,14,26,53
29850,19,612,7,45,263,946
39290,32,1893,9,25,382,2341
43272,0,9,2,7,9,27
28113,8,51,3,52,59,173
11735,50,1291,34,41,598,2014
39227,15,280,16,40,261,612
34537,3129,49067,1083,552,47397,101228
7774,190,4423,121,101,2581,7416
4034,107,954,66,106,580,1813
48877,18,225,12,37,149,441
36561,147,2480,33,73,478,3211
32761,6,256,3,18,47,330
18575,10,134,5,49,76,274
21407,851,4570,716,775,3265,10177
25597,9,73,5,56,97,240
36039,4579,56521,2389,5690,27266,96445
43591,2401,6341,521,737,7301,17301
50998,1,5,0,11,11,28
36010,689,5613,351,367,1512,8532
41189,66,1083,53,73,967,2242
33034,627,12313,301,164,8828,22233
16,13394,87492,12973,12179,115496,241534
32759,8,194,2,16,36,256
48780,511,408,259,66,21578,22822
5678,8503,68267,7869,7984,60381,153004
10384,695,3572,332,327,6171,11097
5070,137,1268,91,156,744,2396
8487,316,6876,164,169,5311,12836
2453,81,1065,64,93,1133,2436
33618,81,704,39,84,872,1780
8754,110,1980,96,86,2036,4308
10887,20,94,13,89,143,359
10050,78,2731,66,91,1437,4403
985,785,87612,295,283,4977,93952
1554,726,11965,894,975,8394,22954
3069,102,1445,65,97,1468,3177
27793,17,2095,16,37,155,2320
45560,26453,6,977,5957,25074,58467
26087,9,62,4,58,62,195
40455,4,28,4,20,40,96
13851,10518,85488,3745,1657,18633,120041
36347,6,108,5,20,30,169
36585,12,91,0,18,47,168
2836,76,2093,94,289,465,3017
37622,135,2860,68,109,2124,5296
39388,7360,28724,3607,8270,26229,74190
23979,18,43,8,46,211,326
30026,10,60,6,61,44,181
11241,6943,87708,4627,7533,32313,139124
16680,265,35093,210,230,4002,39800
37192,7,99,2,22,33,163
1333,34,441,50,130,217,872
37798,15,52,6,32,65,170
5671,4865,42618,3685,4841,30212,86221
47957,0,4,0,8,13,25
2444,137,1249,103,104,596,2189
35838,23256,116943,12476,9790,117644,280109
32274,97,1827,67,115,906,3012
34746,63,93,8,58,204,426
23353,22,87,6,42,161,318
41454,204,1106,109,96,2625,4140
16347,50,1451,32,83,320,1936
5959,1799,9792,853,603,5136,18183
37937,320,1934,66,145,791,3256
12005,38,462,15,66,447,1028
41176,8,808,4,10,45,875
42544,22727,47634,4045,4886,58712,138004
19291,8473,106364,6323,8053,10785,139998
30264,12,319,4,49,111,495
46639,165,63,28,88,298,642
9900,34,286,30,94,370,814
37406,38,1067,11,33,320,1469
22645,12,94,6,41,81,234
38325,542,1627,195,119,4009,6492
38868,2,23,5,30,31,91
41392,12176,31078,3988,9915,40781,97938
7592,14236,141832,9355,9428,71599,246450
36745,10,641,3,44,103,801
19221,14356,260476,6497,9022,82652,373003
48290,5,16,3,25,50,99
814,164,11619,95,136,2281,14295
19071,12,75,3,30,58,178
2120,74,3250,61,109,890,4384
17263,13,90,9,61,108,281
16964,77,1877,41,81,822,2898
10109,1333,9651,965,2081,8875,22905
42357,3,85,0,13,24,125
38936,1505,36789,431,285,13297,52307
35242,8,60,6,56,59,189
48130,3,13,1,22,33,72
18635,31,186,25,111,267,620
8879,12,103,13,89,170,387
37540,4,146,1,12,27,190
36591,8,49,4,20,58,139
38643,3,46,4,15,38,106
28,5701,43213,6203,4973,28201,88291
7494,13,947,7,47,126,1140
51015,11,680,6,5,140,842
552,10143,316270,7925,9327,20316,363981
24273,620,4198,363,318,2133,7632
41496,4,110,2,5,25,146
43623,0,9,1,6,12,28
2314,54,343,19,45,577,1038
9043,81,298,51,70,767,1267
7025,27,1729,16,51,465,2288
32728,25,627,6,40,167,865
37028,14,78,9,44,80,225
40163,15,259,3,41,124,442
2380,190,1114,137,124,817,2382
5828,74,894,50,58,729,1805
5854,141,1115,129,127,1105,2617
35739,286,2812,146,698,1067,5009
49310,502,124,257,19,41226,42128
50993,11,70,0,4,48,133
37223,1365,4256,539,442,1743,8345
4176,57,1185,34,61,929,2266
44616,34,159,18,34,1110,1355
50855,0,0,0,0,793,793
13955,57,1100,51,91,1001,2300
32253,6,53,5,65,43,172
35229,41,0,10,39,69,159
2002,5851,54341,4967,5485,32433,103077
31454,71,1262,60,74,883,2350
30932,7,33,2,51,44,137
2808,172,8204,90,112,2279,10857
39727,0,46,1,1,7,55
38569,4,40,3,38,47,132
2023,130,1252,101,142,1397,3022
5496,82,1206,41,69,879,2277
32551,1222,51729,518,445,13012,66926
49978,7,183,1,12,37,240
21469,700,36805,197,293,4741,42736
38337,4298,19835,1396,970,23875,50374
33023,6452,21438,3186,8472,35702,75250
21851,207,1958,125,139,1965,4394
39428,3,10,2,39,30,84
49920,0,14,1,21,24,60
23989,760,15208,352,307,6094,22721
23985,397,4717,198,191,3176,8679
48125,9,634,3,28,107,781
9599,345,1635,233,200,1227,3640
43325,22865,80239,4458,2364,62544,172470
39470,497,12451,187,120,6201,19456
8449,4495,43362,3067,6366,24896,82186
10623,38,204,35,79,461,817
27631,36705,283400,17990,34932,120860,493887
36874,22,91,12,61,61,247
209,2530,34231,3212,2672,21985,64630
49474,1,35,0,5,12,53
29986,8,53,5,71,55,192
50770,172,1200,46,34,1201,2653
41199,2,25,2,31,41,101
3354,361,20908,308,216,5683,27476
31771,6447,35334,4540,6721,33881,86923
40507,80979,49,1760,2654,131485,216927
34652,34,64,6,39,152,295
32636,13,263,0,22,65,363
9433,34,243,21,120,218,636
1100,176,1460,120,130,2590,4476
5235,100,256,76,119,505,1056
39151,2,35,1,19,30,87
5557,53,299,39,71,261,723
2588,288,1690,147,151,1075,3351
49690,345,970,162,28,2028,3533
29677,11,293,6,37,138,485
3626,229,6077,174,189,3649,10318
21009,356,4169,189,200,2442,7356
9242,28,384,20,61,289,782
41289,0,0,0,0,7236,7236
37401,7,135,1,12,34,189
39382,106,2772,52,72,2100,5102
29255,135,2146,102,97,2163,4643
6946,451,7224,297,291,4159,12422
1093,426,359,221,163,1601,2770
5351,149,3810,117,172,2648,6896
1929,734,9617,700,656,4016,15723
38538,10,57,3,33,52,155
19207,178,1239,148,208,1286,3059
6768,992,29109,594,583,13164,44442
2793,92,1856,55,75,1473,3551
1380,222,6749,152,154,3217,10494
40714,193,160,88,133,710,1284
32999,33,153,11,98,244,539
38674,17,249,4,31,98,399
41063,108,1860,41,61,1117,3187
20109,18,114,9,55,166,362
44148,0,12,1,15,14,42
7960,61,117,27,66,505,776
42054,27,134,17,29,286,493
31490,3040,134738,758,483,21806,160825
34148,3482,40328,1245,2181,17666,64902
30057,7,42,3,42,45,139
182,5692,75234,5447,4533,48116,139022
1679,200,7727,173,148,2061,10309
34707,12,20,1,48,45,126
7419,15,115,13,80,132,355
39215,4,124,1,9,28,166
12765,20,112,19,87,194,432
34177,4611,25076,1846,3933,21519,56985
18003,22,447,11,61,277,818
29643,559,1,303,277,3596,4736
12145,58,1244,43,205,244,1794
33910,10,474,5,18,112,619
24969,16,92,7,68,97,280
11959,23,143,9,46,170,391
24619,27,202,8,60,201,498
31326,2554,63960,958,617,10692,78781
44099,3,66,2,5,17,93
43564,0,9,1,8,10,28
15139,15,230,5,59,107,416
42274,2,65,4,10,26,107
37504,1017,14231,549,692,10949,27438
41490,5,108,3,5,19,140
55,639,7419,745,961,5292,15056
13335,879,15008,370,222,14550,31029
1669,985,53448,863,1880,3307,60483
8964,77,950,54,149,719,1949
40368,20,30,5,59,109,223
10132,15,523,5,29,132,704
49196,1,14,4,10,31,60
47758,1,9,1,7,14,32
44037,38341,94366,3095,6958,54358,197118
13959,34,253,27,75,201,590
40742,2,111,4,7,21,145
3127,102,2976,56,69,1998,5201
34657,10,201,3,15,77,306
48920,3,70,2,3,38,116
2586,85,1803,66,63,1182,3199
34946,19,116,3,41,107,286
18241,23,139,15,95,167,439
1843,56,2064,50,46,734,2950
3547,39,512,28,61,469,1109
12803,20,595,9,52,121,797
732,1078,53508,519,436,16907,72448
7897,471,12911,235,370,4511,18498
48310,2,18,2,18,37,77
1926,33,1748,26,54,484,2345
825,213,9153,158,200,2121,11845
1574,123,370,140,171,1041,1845
32189,15827,214303,7654,7467,64462,309713
2357,435,2848,232,283,1313,5111
29367,17,89,7,51,91,255
6937,45,466,29,53,476,1069
81,2810,49140,1618,884,16648,71100
33217,6,256,2,23,46,333
50005,0,54,0,2,7,63
38766,11,248,1,24,45,329
9822,42,156,24,69,251,542
48085,0,3,1,9,13,26
2598,436,1175,327,230,3287,5455
48844,20,24,9,37,72,162
7579,91,2266,61,68,995,3481
42914,33,327,39,51,368,818
44013,1,16,1,24,25,67
16480,14,88,10,76,123,311
43999,1,22,1,18,23,65
36525,4902,24368,2035,6820,18712,56837
20023,16,83,5,79,102,285
2376,160,1240,91,111,603,2205
4151,4031,28874,2844,3729,23709,63187
6402,402,2553,221,219,1475,4870
36429,46,103,18,66,267,500
37693,10,93,1,18,37,159
34115,6,137,2,24,40,209
11611,16,105,6,38,108,273
1512,160,1644,102,134,777,2817
18463,11,371,3,22,60,467
6024,2146,12855,1947,1607,8636,27191
3390,155,1188,126,214,1584,3267
1240,367,30481,293,209,5982,37332
31610,2670,16371,1615,1610,10045,32311
16159,23,136,18,90,196,463
39495,1151,15486,295,92,16998,34022
23367,73,1304,48,62,654,2141
4088,46,199,85,167,343,840
36671,8,130,2,20,39,199
1034,957,17929,440,267,19342,38935
7083,242,4300,175,188,3499,8404
31052,8,101,5,46,88,248
34439,1267,33524,714,516,26877,62898
29780,14,179,6,33,88,320
838,1455,11099,1158,1344,17287,32343
818,523,6243,466,660,4774,12666
39208,7,351,4,27,67,456
6098,2032,20064,1550,1626,15320,40592
1313,3335,185904,2996,3699,9845,205779
32730,110,3595,72,99,1510,5386
14211,24,182,22,127,354,709
43020,9,302,7,23,77,418
7591,87,2397,48,109,1115,3756
24975,63,857,57,74,1027,2078
283,1452,9871,1238,888,13293,26742
38902,378,309,130,145,2903,3865
34454,1367,2,350,453,4661,6833
2456,37,1165,19,50,451,1722
43409,0,7,2,5,10,24
18355,11,93,8,64,97,273
28385,140,1409,102,133,1501,3285
20077,20,133,9,80,95,337
35057,9,25,2,39,41,116
38304,4,82,3,15,28,132
11715,262,3882,252,186,1942,6524
37075,7,155,0,22,30,214
2580,153,8364,137,91,2438,11183
30875,12,72,3,87,76,250
2717,172,1287,162,134,1858,3613
139,2545,105145,972,865,18517,128044
12337,38,326,16,78,391,849
5400,108,526,55,89,460,1238
9324,69,1078,40,42,690,1919
32750,8,356,4,28,68,464
42267,872,1,83,143,443,1542
37779,88415,1284272,23963,22002,201994,1620646
41734,15,29,11,39,313,407
32227,8,85,3,48,52,196
35148,5,26,1,29,31,92
32270,10,76,1,51,55,193
40673,3,17,2,26,33,81
37661,13,106,7,45,184,355
38480,13504,97461,5448,7155,71504,195072
36485,398,3355,225,201,3035,7214
2457,119,1434,88,100,1061,2802
31581,108,1087,71,75,1532,2873
41558,345,721,152,677,1439,3334
2306,67,1850,62,132,1100,3211
6900,85,322,68,153,646,1274
8960,52,358,65,111,630,1216
595,186,8466,117,132,3080,11981
36392,10,143,3,29,40,225
38125,4,97,1,57,32,191
10201,70,1296,55,61,942,2424
43434,0,0,0,0,1760,1760
29363,30,223,12,70,199,534
38035,744,1714,258,207,848,3771
41180,8,674,3,10,51,746
30367,16,879,9,48,93,1045
34492,993,4602,476,364,2482,8917
49633,34,221,41,36,426,758
7178,692,3769,393,289,2384,7527
5833,44,295,42,106,308,795
38627,31,103,12,43,181,370
7724,26294,283877,17769,18076,185306,531322
7495,5,58,13,71,89,236
11729,24,720,4,33,151,932
36746,11,617,5,37,94,764
7956,28,173,17,88,164,470
31631,2239,1703,1213,3196,5916,14267
9662,18,263,9,37,505,832
43674,0,6,1,6,10,23
30246,112,1123,112,110,1721,3178
9979,108,3471,67,122,1524,5292
36798,262,5365,134,116,2651,8528
3560,140,2046,91,114,655,3046
42641,70,102,36,62,1628,1898
20871,206,6614,149,191,2457,9617
880,1763,46002,1683,1257,10975,61680
15335,4444,145935,1501,1411,50810,204101
3059,226,1521,205,223,1836,4011
14529,21,194,4,60,148,427
38005,1649,7111,440,730,11294,21224
17397,1896,23969,706,1297,12212,40080
35849,113566,954389,33914,74422,190026,1366317
42235,2,6,4,10,36,58
15407,458,0,229,171,8148,9006
31068,93,1090,52,153,547,1935
5074,1744,29418,1239,712,15018,48131
44053,54,0,13,27,101,195
42451,15,221,9,19,366,630
9821,15,105,5,54,73,252
32998,39372,324551,24655,23663,189376,601617
3983,103,542,52,90,386,1173
32897,17,96,10,44,128,295
12503,701,41918,660,689,11352,55320
31410,69,248,52,125,444,938
13379,415,1985,259,197,1166,4022
1014,106,3365,112,104,1449,5136
4483,1287,7716,1105,978,13371,24457
5956,29,391,13,48,258,739
28725,8054,171918,2636,958,102267,285833
1696,1769,35455,1582,1620,13697,54123
40037,24,39,13,37,345,458
34411,935,4314,351,1683,4301,11584
12397,46,183,38,87,210,564
30036,16,93,9,43,114,275
18115,32969,539682,17166,13027,144643,747487
6868,25,149,19,89,363,645
22175,14,323,7,34,94,472
13143,131,2583,85,407,817,4023
35680,14,117,17,40,869,1057
31555,24,116,9,84,198,431
8287,278,1853,226,493,1417,4267
10810,159,5964,76,168,715,7082
36391,7,85,3,22,27,144
38811,1,140,0,9,22,172
5159,69,449,33,72,327,950
35049,7,33,3,49,54,146
7720,1600,27959,1151,669,9364,40743
386,523,3676,462,411,3599,8671
9963,544,36536,244,270,4197,41791
671,318,3382,386,555,3216,7857
39222,120,0,73,57,266,516
36079,8,115,3,8,27,161
49354,3,7,7,22,42,81
43643,0,8,1,5,12,26
37692,8,133,0,18,33,192
33300,15,95,6,67,82,265
17491,690,6562,334,367,1871,9824
10286,163,1411,112,103,640,2429
35275,6,38,1,51,38,134
24849,401,2473,203,179,1140,4396
42347,3,99,3,9,19,133
34693,9,57,3,28,57,154
39014,496,8224,355,224,13501,22800
42540,6,24,3,18,34,85
43505,0,3,1,8,11,23
9166,32,314,19,89,294,748
37764,409,9193,149,129,5240,15120
39384,3,17,2,31,29,82
35529,12,63,5,36,53,169
4411,77,571,63,123,540,1374
31368,1390,43717,551,337,8748,54743
40873,321,4721,138,95,3575,8850
9943,334,709,316,228,1618,3205
39132,3,33,2,34,32,104
49145,151,2538,134,95,1716,4634
21763,10,78,10,89,82,269
50593,1,0,0,0,3409,3410
8900,22,183,26,75,252,558
30702,627,7378,340,294,2118,10757
11389,11,178,10,48,95,342
44059,518,21683,115,52,7577,29945
2140,291,3068,198,177,1217,4951
41463,100,657,89,35,1034,1915
1178,180,2930,128,146,2121,5505
30211,9,270,5,34,82,400
9501,22,163,10,45,195,435
10347,94,333,50,248,455,1180
19171,53,289,36,75,257,710
42455,26,253,15,36,248,578
34914,13535,149135,6510,5088,56699,230967
10948,138,2921,130,131,2693,6013
34600,19,116,0,29,92,256
12501,166,4748,79,112,1806,6911
34601,11,132,3,36,67,249
50846,222,306,45,32,2238,2843
34980,19,157,4,52,101,333
514,2062,33004,1700,1986,25685,64437
50029,8,288,7,13,75,391
37351,6,106,2,21,33,168
29371,11,42,3,40,51,147
33771,5186,25410,2708,10279,18346,61929
36882,31876,365576,6470,32554,89520,525996
2905,490,14956,357,288,5351,21442
35843,8759,104444,2605,1482,49018,166308
36919,29,1374,20,49,383,1855
43238,0,8,1,7,10,26
38528,2210,30353,536,570,7452,41121
40940,2278,2955,603,919,9121,15876
28929,874,7637,530,4085,5740,18866
38818,4,163,2,11,55,235
34022,128,0,32,71,681,912
22147,22534,403010,13112,15358,125023,579037
4672,1396,52559,781,642,27325,82703
3914,248,6357,123,196,5026,11950
1137,488,9673,575,700,3054,14490
48513,255,3030,142,152,950,4529
17457,19,85,10,80,121,315
21713,22,149,15,61,129,376
17965,29,326,16,73,367,811
50746,6,30,3,10,22,71
30749,19956,232464,7148,14508,68952,343028
38659,32331,355749,9063,13833,76738,487714
50038,4,98,0,2,21,125
21939,14120,129508,6904,2967,109815,263314
34323,47,237,17,50,478,829
34866,8174,11655,3568,5735,10203,39335
26301,10,77,7,34,101,229
40593,2,30,4,28,30,94
25613,6,63,5,60,49,183
36725,139,3089,80,105,1633,5046
27567,63,1485,46,42,907,2543
17697,94,278,48,65,429,914
636,361,5492,347,316,3649,10165
38122,4,98,1,54,39,196
4983,821,12000,325,345,13016,26507
33772,13,58,5,39,64,179
47728,3,18,2,17,29,69
40016,7,184,1,34,54,280
3551,120,1043,63,112,611,1949
7041,296,7513,209,169,3875,12062
50076,2,81,0,3,15,101
379,5181,49854,7160,7703,30087,99985
34919,11,81,1,28,55,176
1933,55,844,35,46,616,1596
10444,632,18362,520,639,4748,24901
6610,1636,41508,655,368,23208,67375
48673,3,49,1,3,17,73
3791,557,36720,342,261,6878,44758
37996,504,29691,268,139,10139,40741
38471,12,225,1,34,120,392
35975,12,300,3,28,100,443
1662,84,1296,52,55,1320,2807
48426,0,0,0,0,1753,1753
7691,77,952,55,67,861,2012
1645,194,2904,138,139,2303,5678
24023,0,0,0,0,1228,1228
33768,1862,3708,699,428,2234,8931
29409,8,221,5,38,47,319
31866,186,865,99,110,2906,4166
40540,30581,343456,5441,7543,85399,472420
35369,338,13518,116,114,2764,16850
35252,3642,13216,1415,6899,12040,37212
31559,11720,91452,6950,15377,36001,161500
4147,52,1801,43,104,1035,3035
31239,16,95,7,86,81,285
9887,94,520,67,109,609,1399
5232,45,427,36,95,805,1408
19515,24,91,10,50,187,362
30249,36,117,17,49,322,541
12243,28,140,17,67,314,566
36797,198,983,100,456,959,2696
19697,962,20494,681,305,9160,31602
37225,17,89,8,48,170,332
11268,55,330,82,129,347,943
25859,4004,26346,2902,7298,16084,56634
8861,17580,290010,8868,21995,96309,434762
6909,55,1215,26,72,740,2108
36604,823,2676,150,153,2505,6307
49902,0,34,0,2,8,44
2130,4854,34286,4126,4761,25294,73321
19397,73,958,46,75,749,1901
36619,15,70,12,28,145,270
2235,311,17231,122,122,5291,23077
32637,14,319,5,32,67,437
10378,3543,58212,2824,2089,21590,88258
42258,5,70,1,9,55,140
1437,107,4167,103,100,2389,6866
15417,9193,175253,3272,2337,82435,272490
3614,920,6704,709,742,8218,17293
41763,4,113,3,4,16,140
30470,37,104,14,104,138,397
33519,1131,19635,522,539,18952,40779
8664,53,547,26,43,736,1405
41251,2,77,3,3,14,99
43352,6,112,3,5,18,144
40861,1437,12413,506,338,3409,18103
32765,5,320,2,17,73,417
42591,1038,1696,289,281,1076,4380
11783,3628,70752,2725,3280,16164,96549
36373,7,94,1,15,51,168
9776,4373,51641,3576,5734,28306,93630
35150,4,27,2,54,38,125
8507,420,7556,268,204,4643,13091
3093,121,882,85,107,661,1856
50007,4,93,0,3,13,113
30757,2907,5441,1503,2675,10148,22674
29453,9,213,1,37,38,298
38812,1,169,2,13,35,220
8646,18,1405,10,70,165,1668
36790,134,1282,46,64,546,2072
655,221,4310,210,191,2436,7368
23983,21,185,4,66,134,410
5992,129,871,122,185,833,2140
40364,3,90,2,11,18,124
9531,39,372,9,44,287,751
5484,179,1308,225,149,1269,3130
9721,661,6429,384,332,2146,9952
1037,335,3548,285,547,3838,8553
14131,11674,159495,7367,10004,74310,262850
36122,507,2064,218,219,1026,4034
34416,13,83,8,52,120,276
6015,93,387,62,73,387,1002
2476,14918,438062,8565,27036,107864,596445
1292,8905,224414,5716,6480,79826,325341
43801,0,9,3,9,10,31
7744,223,4678,154,119,1561,6735
11471,97,2298,70,142,1386,3993
39380,429,5770,142,130,1904,8375
6743,198,2698,122,142,1828,4988
1595,175,1043,127,152,943,2440
4437,2180,207792,831,608,18041,229452
25069,25,283,13,75,193,589
17405,28,112,21,50,453,664
23327,7135,97529,4459,2196,36983,148302
36781,9,185,3,9,57,263
16644,477,4410,296,229,1488,6900
3991,196,1944,141,127,2481,4889
40665,149,1691,77,69,2829,4815
30806,7219,48845,3917,9736,32946,102663
17989,29,163,11,52,260,515
43729,69,64,41,46,738,958
49222,1684,5,511,211,926,3337
24625,2129,28983,961,1229,6139,39441
35992,16,336,7,24,166,549
11815,414,1895,219,173,1013,3714
4382,15405,346325,10703,9972,94633,477038
33299,3355,25757,1249,2286,16735,49382
1735,406484,1257171,125581,139419,109984,2038639
3498,36,529,29,54,447,1095
29397,11,172,4,36,56,279
26299,9,40,2,46,57,154
6213,29087,321166,18710,14404,156669,540036
25099,12935,157487,4976,7955,59501,242854
36778,6,215,1,9,38,269
8548,30,570,27,53,462,1142
33415,30,29,5,57,107,228
36172,9,237,0,11,46,303
48067,2,6,0,11,11,30
4202,62,1061,95,62,750,2030
28653,9,194,6,27,83,319
37249,15,286,13,65,222,601
33871,24,390,6,48,117,585
19749,13,68,4,41,76,202
50193,0,0,0,0,140,140
3105,213,2353,136,135,840,3677
33908,7,211,3,20,52,293
28293,10,76,6,58,92,242
40832,11,63,3,57,57,191
49717,0,0,0,0,207,207
41160,2,22,5,24,34,87
35446,1655,4289,558,451,1860,8813
49963,1,54,2,12,25,94
42285,242,221,50,114,1044,1671
2726,203,2344,86,92,2850,5575
43818,0,16,1,4,10,31
44209,18,39,6,30,151,244
43577,0,8,1,7,9,25
30865,20,482,8,41,153,704
32377,68,991,19,36,447,1561
42990,381,7778,144,129,5067,13499
20539,50,348,32,93,360,883
3468,164,6304,125,129,2121,8843
1827,11283,82290,8636,5377,90137,197723
869,265,13844,215,124,4080,18528
9053,43,602,35,63,614,1357
13307,45,193,44,117,447,846
37537,50,1126,21,44,533,1774
32543,166,1007,62,78,948,2261
40244,4,78,7,22,87,198
43774,1,77,3,10,25,116
40272,1127,6276,413,508,9896,18220
50421,0,0,0,0,890,890
17165,29,279,16,50,226,600
354,422,4024,337,693,3242,8718
6513,41,646,26,58,458,1229
605,335,2272,389,541,3131,6668
2124,550,23995,489,544,9226,34804
42946,174,1162,56,212,385,1989
1794,111,2637,80,55,1401,4284
462,1008,72504,490,319,10510,84831
13309,50,3558,29,55,510,4202
34529,589,3266,319,308,1909,6391
32574,662,26263,386,177,9622,37110
41261,1169,14194,514,518,2641,19036
8246,1954,193898,792,558,18156,215358
11857,25,121,18,81,213,458
1030,1014,67502,637,539,19251,88943
36119,150,2267,54,84,1295,3850
38611,10,85,7,45,53,200
8689,39,1677,12,55,623,2406
29135,16,202,8,39,168,433
2474,89,1362,52,57,958,2518
2260,72,772,82,95,971,1992
33929,2923,119759,1007,609,31431,155729
29361,34,26,3,67,103,233
7856,12,95,9,47,205,368
49501,464,571,150,115,2771,4071
22859,554,24686,393,225,7959,33817
35699,25,33,13,52,61,184
12001,384,12902,354,369,6583,20592
4479,117,764,69,83,525,1558
7526,19,95,13,87,144,358
28989,19,228,6,37,111,401
36835,13,299,9,37,120,478
35409,8,218,2,35,53,316
31753,19,60,9,79,105,272
48071,0,5,0,8,13,26
3032,230,15904,198,168,3558,20058
33894,10,25,1,34,38,108
3947,53,220,36,102,552,963
44097,148,401,48,63,856,1516
31072,70,808,37,80,1083,2078
1095,944,21470,378,188,15335,38315
32175,5183,41401,2758,4709,21007,75058
2953,91,10887,50,56,1685,12769
40709,3,174,3,7,22,209
30765,7,31,1,45,39,123
3500,18,98,11,63,124,314
30056,1244,26111,918,731,9207,38211
47023,3,10,2,19,22,56
48654,1129,1495,334,284,781,4023
39559,75,13,29,48,413,578
36258,9,509,3,10,51,582
11615,368,9419,216,215,2340,12558
19997,26,106,18,78,174,402
38647,25,132,16,69,476,718
39731,117,297,51,81,765,1311
35623,28,127,6,29,112,302
39517,4,128,0,10,22,164
8953,28,237,18,63,367,713
35507,38021,653181,10613,13062,131291,846168
16794,12,219,5,38,159,433
45627,3,67,0,5,16,91
48873,23,21,9,37,106,196
38742,376,882,105,188,2562,4113
46588,1,42,1,5,21,70
3805,224,2486,140,164,2622,5636
12355,13155,519721,4034,1504,179558,717972
50321,2,5,1,6,15,29
39213,4,151,2,13,20,190
49439,0,53,1,3,17,74
668,924,7034,684,1316,5181,15139
32836,2283,17128,784,714,10637,31546
11281,37,683,25,55,471,1271
20973,7964,65315,4622,6282,48728,132911
48997,47548,8,1082,2187,26833,77658
4114,227,1956,177,203,1877,4440
22817,1168,7569,861,1337,5699,16634
22329,15,139,8,50,162,374
48466,4404,5663,639,2673,8245,21624
5192,16,154,15,42,189,416
34530,612,4872,356,355,1721,7916
44221,632,2409,141,130,2283,5595
9170,122,3565,129,140,2135,6091
41590,922,16006,353,276,10382,27939
10180,193,2512,98,125,2453,5381
26091,9,32,3,40,57,141
37653,24,54,14,92,98,282
35308,11,64,8,56,76,215
870,349,13986,206,227,4064,18832
3361,60,333,36,122,356,907
37245,3034,13062,982,2551,6031,25660
18317,7,60,1,39,62,169
43469,0,7,1,5,11,24
49996,3,51,0,2,9,65
7643,303,698,172,289,876,2338
42994,0,0,1,0,7398,7399
3159,202,433,232,219,1553,2639
39448,19,232,22,40,188,501
42959,893,5547,239,318,4592,11589
32147,12,116,9,66,105,308
51004,1,45,0,1,7,54
2245,205,1403,174,234,2607,4623
38083,1753,5012,648,2128,5807,15348
19569,612,3132,344,228,1642,5958
1999,83,1452,72,68,1133,2808
34634,9,277,4,16,71,377
16486,17,159,13,89,218,496
30958,8,38,3,45,50,144
7590,7119,74071,4317,6110,37730,129347
36389,8,103,2,29,27,169
2542,346,5171,358,360,2644,8879
28071,74,206,18,91,375,764
49014,9,277,4,8,182,480
23137,203,1965,152,174,2562,5056
43387,4,33,4,11,53,105
34165,125,2791,91,110,1354,4471
36297,89,868,30,47,634,1668
51122,0,0,0,0,2911,2911
6533,40,2294,15,40,488,2877
1393,65,1430,40,74,728,2337
40966,147,1221,29,73,295,1765
22069,1368,11335,713,549,5124,19089
8841,21996,421673,13876,18737,101450,577732
11299,64,940,32,65,588,1689
479,6057,55354,5217,5315,36346,108289
34314,69,884,38,99,364,1454
31262,12,465,10,26,144,657
33543,16,337,13,65,150,581
19839,19,76,10,50,132,287
1881,325,3016,290,365,3159,7155
10330,916,33950,512,1500,3664,40542
39718,5,124,2,13,35,179
40894,385,1277,220,202,3339,5423
32758,7,200,2,21,36,266
20843,278,5892,187,137,3089,9583
36857,19,95,14,52,346,526
34194,9,61,6,49,86,211
42963,5,1,3,0,178940,178949
9773,44,792,39,57,420,1352
4096,13,176,6,35,96,326
6041,627,3775,378,312,2663,7755
12971,21,220,9,40,231,521
656,404,30928,422,284,6726,38764
38911,7,83,3,31,37,161
23867,8,65,6,59,60,198
37046,292,2734,171,133,3141,6471
36856,30,89,14,56,177,366
3960,29,617,17,41,727,1431
25071,15,106,4,52,138,315
36849,969,2780,401,259,1576,5985
2231,257,925,201,229,1879,3491
31299,22,162,9,42,128,363
12121,87,3190,40,108,788,4213
40674,4,13,3,30,42,92
13267,1864,14805,1239,324,6480,24712
32583,8,158,0,28,36,230
42105,2,109,3,7,17,138
10721,17097,113635,13988,11842,117044,273606
19297,77,2462,49,75,714,3377
39026,35462,167719,15895,19315,81802,320193
34595,23,621,10,32,258,944
46000,70,433,43,88,844,1478
31890,854,4122,567,1824,4291,11658
1341,281,6485,121,159,3798,10844
3939,1670,5853,696,539,3762,12520
43546,0,8,1,6,11,26
36093,6,176,0,13,37,232
6685,572,2425,320,260,1689,5266
645,368,16964,198,181,4331,22042
47764,0,4,0,8,12,24
37719,2296,59812,674,673,13290,76745
33904,347,1,170,126,444,1088
9159,721,6973,399,276,3876,12245
49049,6,401,5,9,50,471
6999,84,4205,82,104,1465,5940
9523,77,1970,48,70,1063,3228
34510,22,265,7,61,133,488
5002,48,327,25,65,704,1169
39194,1036,3977,427,1483,3380,10303
33048,123,387,75,109,2290,2984
10870,214,5569,226,241,5338,11588
37448,226,856,78,491,2042,3693
499,513,10650,211,165,7023,18562
18795,22,455,12,51,156,696
39342,2,17,2,24,35,80
17753,22,158,9,43,199,431
36204,69,121,33,71,1428,1722
34370,8,47,9,50,64,178
35616,10,77,2,29,54,172
582,789,3385,720,672,5942,11508
10709,23,82,16,68,195,384
251,10213,40898,9793,9520,31729,102153
46940,1,3,0,11,19,34
25661,20,203,7,51,137,418
35589,9418,22094,3819,8986,27387,71704
39365,1897,2,661,235,1174,3969
3302,565,3979,359,270,2091,7264
3695,38,330,23,46,436,873
39736,325,215,123,155,1751,2569
937,504,17786,281,272,8214,27057
43642,0,6,0,7,12,25
35255,623,2670,303,309,3723,7628
2338,158,764,98,150,792,1962
35311,52,0,25,52,104,233
40064,1151,36018,361,464,7974,45968
24833,101426,1211805,63679,54246,239102,1670258
29928,6,146,1,45,62,260
29233,17,279,9,71,146,522
36538,1708,26254,620,296,29237,58115
2441,290,2837,168,175,1303,4773
14653,1899,33118,1494,2166,12548,51225
37807,659,6226,338,109,27566,34898
31373,23,392,20,72,597,1104
34501,4284,43946,1502,3308,18247,71287
28149,4383,11636,4066,1868,14401,36354
38226,1106,7618,502,2278,3808,15312
37992,2364,20181,790,4169,10029,37533
4081,28866,201332,19604,10834,211440,472076
7059,1724,141663,907,865,22685,167844
9371,27,65,17,76,228,413
35011,90,103,66,108,324,691
1850,31,325,24,40,378,798
44273,455,0,66,90,751,1362
43314,1,15,0,4,12,32
1622,125,4600,78,130,2362,7295
29629,14,772,7,36,136,965
39734,93,778,32,38,452,1393
34751,697,9527,313,272,8137,18946
357,4318,132536,3031,6003,34684,180572
43432,6,11,6,14,56,93
4774,123,707,63,109,682,1684
9991,20,343,15,61,288,727
39083,5,56,12,74,59,206
20153,11,495,4,29,133,672
39094,515,3786,269,170,4879,9619
33536,14,280,0,28,115,437
42091,1603,31417,696,936,34636,69288
3429,138,5093,103,74,2472,7880
35247,13483,202029,4558,2108,115778,337956
28553,7,32,2,47,38,126
17251,833,4397,406,378,2124,8138
42291,246,219,46,106,404,1021
39452,25,2173,4,19,80,2301
30929,8,63,4,67,51,193
2217,114,6510,93,79,1361,8157
44848,19,83,9,62,169,342
34926,16,39,5,33,82,175
4485,107,811,61,75,1394,2448
42745,1,0,3,1,26361,26366
30969,7,56,1,55,39,158
28069,1231,77428,671,354,17924,97608
30232,27,121,11,86,228,473
24041,12,49,6,70,72,209
8302,935,23622,515,518,5806,31396
754,246,852,322,275,2222,3917
48784,0,11,2,18,32,63
21877,11257,134885,5354,8671,57529,217696
50435,341,2,106,45,469,963
19233,17,846,12,43,213,1131
5372,82,867,59,77,956,2041
26441,8778,73696,6435,8764,42583,140256
10481,34,262,20,51,422,789
11465,453,2970,263,243,1464,5393
2462,105,2466,64,102,1089,3826
16662,4139,194459,1839,816,64476,265729
38040,12559,483369,3150,2250,108752,610080
2266,185,1554,136,153,875,2903
4811,437,14825,262,149,4511,20184
36274,5,39,3,38,42,127
36070,8,157,1,12,37,215
2373,140,796,68,107,570,1681
50597,12,185,2,10,99,308
21547,17,73,6,51,122,269
3280,29,409,22,74,349,883
3530,70,444,38,72,286,910
5651,1346,3422,442,392,2230,7832
34173,78,1669,26,60,717,2550
1848,187,723,153,205,1552,2820
1732,308,12080,238,166,4187,16979
33191,9590,79221,3895,1051,21332,115089
33105,50,552,26,67,476,1171
48942,244,184,32,59,194,713
9608,315,10420,121,100,4529,15485
39450,6,60,5,48,57,176
31476,31,544,14,68,276,933
24371,107,2304,71,112,1581,4175
15379,14201,203508,8071,10891,68562,305233
1748,91,1257,101,104,930,2483
12487,3517,47531,2391,1984,21636,77059
3594,5504,34834,4237,5375,24315,74265
827,371,3267,234,221,1301,5394
33475,17855,231619,5822,12261,57392,324949
34706,8,27,3,38,51,127
2737,48,452,26,50,479,1055
2957,190,1515,121,138,815,2779
14049,294,6909,160,170,3046,10579
48061,0,5,0,10,13,28
31170,13,211,0,42,62,328
48083,0,5,0,11,13,29
34782,44,143,17,67,340,611
4050,157,1495,149,202,1071,3074
8553,47,408,31,118,353,957
30106,8,138,5,38,58,247
886,1256,36039,967,1384,8189,47835
5743,607,2755,349,255,2045,6011
762,1142,99627,593,421,12835,114618
2253,985,7010,934,964,5317,15210
1834,141,1685,97,125,739,2787
35238,630,2373,287,230,1185,4705
41339,48,558,26,24,593,1249
41674,216,2408,127,53,5940,8744
10780,39,694,23,55,383,1194
8345,18,99,9,79,134,339
4197,666,9948,618,799,3918,15949
1340,76,1985,36,72,1137,3306
16253,16,70,3,60,95,244
40283,5,166,5,12,37,225
2172,71,1943,44,104,681,2843
24865,7,60,7,53,89,216
39547,47342,357245,12550,7415,150127,574679
9561,56,1005,29,82,427,1599
38136,6,83,1,52,37,179
37678,75,0,32,65,58,230
40143,43,1274,24,53,427,1821
38157,1412,4584,649,2085,7089,15819
1150,194,2313,111,122,2082,4822
18197,67,240,26,77,289,699
7626,21,274,17,66,239,617
5129,46,492,35,100,286,959
3869,34,155,34,89,216,528
23849,129,4193,139,184,2433,7078
654,62,2183,80,61,1079,3465
25439,64,2355,57,63,1002,3541
11731,13,66,7,48,92,226
45921,1,3,0,11,21,36
28685,18,213,2,37,154,424
6864,2176,40961,1070,484,18322,63013
35708,13,143,2,37,78,273
316,322,2791,193,206,1622,5134
35590,48,0,26,72,67,213
6181,37,650,30,48,420,1185
43573,0,7,0,7,10,24
22495,12,169,5,43,104,333
33059,8,91,2,29,35,165
2621,135,2497,69,130,2481,5312
46307,1,5,0,9,18,33
38312,9,42,7,34,81,173
16620,12,111,5,42,97,267
3130,44,562,49,129,215,999
262,223,6017,157,137,2356,8890
5155,679,3632,643,837,7576,13367
4371,53,628,26,60,511,1278
10250,44,748,35,177,140,1144
31633,706,4679,369,3019,4015,12788
30751,72,960,28,101,469,1630
17819,143,11085,89,124,1884,13325
580,130,3979,142,290,1382,5923
23427,354,20549,158,88,3031,24180
50983,1,9,1,6,16,33
25183,36596,304918,20011,23623,119970,505118
2527,104,1430,65,79,1075,2753
38669,540,1704,186,346,3740,6516
29710,6,144,6,33,79,268
32013,8758,91128,3732,5195,53372,162185
35999,77,281,66,790,3758,4972
12551,43,264,38,76,241,662
41335,6,124,6,15,124,275
2821,162,1429,99,142,695,2527
846,4255,110397,4084,2988,25310,147034
3842,49,1008,37,66,899,2059
50175,5,1,3,1,32043,32053
11897,17,2496,8,58,189,2768
16233,16,1816,10,43,282,2167
913,397,1615,335,472,2569,5388
219,287,10393,191,122,3504,14497
2991,150,1800,97,125,778,2950
38128,5,90,2,57,36,190
10216,3080,39580,1744,2436,23742,70582
39638,4169,12,846,169,5579,10775
1977,67,1477,46,39,1363,2992
17090,12,149,11,98,100,370
39211,10,519,5,14,112,660
1417,127,4534,102,95,2423,7281
48653,306,8708,42,56,883,9995
29669,8,146,4,48,63,269
34613,83,498,53,124,953,1711
651,548,19315,285,326,3284,23758
41307,106,461,44,55,2008,2674
37463,6,59,0,23,26,114
39351,10,53,11,39,168,281
8440,969,41887,643,679,13350,57528
10808,2206,15393,1725,3004,6671,28999
31758,8552,281761,2446,1168,95616,389543
8782,14,543,7,34,161,759
30895,5936,33655,3948,12400,28423,84362
29457,7,172,2,29,42,252
23623,9823,109425,5217,2568,50572,177605
1772,77,903,44,101,779,1904
50419,34,0,25,15,179,253
7864,71,285,36,80,277,749
5321,281,1773,169,144,1021,3388
26123,22574,16270,7699,1651,22935,71129
730,177,4933,98,241,1684,7133
3562,88,847,44,92,448,1519
3009,378,4586,327,526,3194,9011
1742,148,932,103,142,1501,2826
23651,12,109,17,78,74,290
21967,12,104,7,67,86,276
2652,34,2170,29,85,416,2734
19923,24,175,21,59,337,616
50499,1,36,0,1,4,42
143,2566,35534,2123,3213,21434,64870
33915,15,189,9,55,128,396
4014,50,556,28,49,557,1240
49830,7,354,3,5,30,399
10302,127,8345,131,153,2094,10850
48932,0,51,0,4,11,66
34852,33,136,14,68,230,481
34723,339,11903,147,182,2684,15255
41230,3,76,0,3,12,94
38320,3,74,4,14,21,116
2442,192,1489,109,131,901,2822
21843,20747,211265,11429,11608,115166,370215
23475,175,1304,121,116,651,2367
22839,1507,47015,396,219,18737,67874
33909,11,487,7,18,92,615
4467,26,1638,10,35,391,2100
12715,107,1070,53,58,1111,2399
2020,365,22902,318,249,5124,28958
29922,6,125,2,34,63,230
40749,338,1280,137,131,2050,3936
5606,102,418,68,90,480,1158
10014,329,1392,382,464,2759,5326
3656,3605,24833,3262,4809,19648,56157
13259,67,3953,36,62,694,4812
36083,210,2008,111,117,2599,5045
8724,8,190,5,32,77,312
4511,29,339,38,96,303,805
1693,425,3153,416,717,3476,8187
37089,662,5860,332,332,1560,8746
1695,1283,9662,1275,1030,11899,25149
16049,15850,235096,8633,5397,79410,344386
1497,69,2214,53,88,1456,3880
32397,105,596,56,66,1049,1872
40197,394,2867,150,739,888,5038
29946,9,446,6,21,57,539
38926,22,0,15,44,50,131
21121,19,100,9,42,204,374
28829,6,235,5,49,71,366
23799,10,77,6,67,74,234
43609,2711,102287,723,421,52664,158806
23945,4395,37606,2633,4534,19489,68657
5211,377,2118,223,174,1377,4269
37017,7,84,5,34,45,175
8228,70,1025,39,43,787,1964
8226,28,324,12,73,271,708
34692,9,63,2,29,72,175
48554,26,1673,13,22,151,1885
10855,16,85,9,58,94,262
1233,281,3499,220,280,2718,6998
40785,2,100,3,6,22,133
2723,148,1035,136,227,1224,2770
43369,0,8,2,9,11,30
7939,29,239,44,65,318,695
37306,558,7955,316,146,9831,18806
3165,200,15023,195,139,3432,18989
23325,3906,19228,2758,6442,9798,42132
99,1250,32436,1271,1690,11710,48357
27891,1711,90066,718,951,14057,107503
8179,20,111,17,100,152,400
2823,69,1693,83,338,285,2468
6761,11,127,5,47,93,283
34661,142,1199,66,103,1290,2800
2662,49,3114,44,104,566,3877
4756,71,1468,50,46,1249,2884
44068,388,1004,68,76,1040,2576
2181,86,1383,53,71,961,2554
48492,18240,8443,3696,13420,29542,73341
8196,18,200,13,80,245,556
49960,0,5,0,9,16,30
4991,30,544,14,68,368,1024
5238,43,501,64,77,1282,1967
17115,592,31503,566,639,5806,39106
7446,13,523,7,29,94,666
38037,1620,2871,594,464,2350,7899
37516,236,3677,137,103,5533,9686
38075,8,82,6,47,48,191
9014,1588,25764,779,750,9973,38854
37710,111,870,45,105,1312,2443
37893,780,11254,293,398,5605,18330
43283,0,7,1,6,11,25
16033,517,8174,363,363,7884,17301
3418,166,581,117,157,1190,2211
16528,2645,83957,1146,641,41372,129761
30385,8722,58925,4156,12508,37505,121816
30167,6,213,1,36,34,290
47791,0,6,1,14,19,40
9515,3042,246200,979,917,25789,276927
23269,3211,44187,2130,1541,21694,72763
34152,1655,67513,663,354,19258,89443
1193,252,2036,235,325,2106,4954
23237,1317,45166,954,511,13782,61730
65,2201,76957,2188,1757,15575,98678
50953,0,0,0,0,3453,3453
17273,441,11496,267,261,4762,17227
1257,1086,42395,579,534,6336,50930
35273,6,21,0,39,32,98
31297,2071,153323,1025,758,27357,184534
33232,74,541,25,64,729,1433
437,10249,352100,3299,1326,171058,538032
2907,328,4458,473,627,1459,7345
39395,3,200,5,12,24,244
473,276,3521,287,347,2400,6831
6535,27,3021,19,83,599,3749
40834,183727,59,5210,2419,98332,289747
2694,145,535,101,128,1866,2775
29209,9,40,3,44,48,144
28309,895,9394,441,324,2790,13844
45572,13292,32217,2612,6048,51595,105764
30161,9,97,5,41,47,199
37954,46,1910,13,51,424,2444
9362,695,15870,430,315,5279,22589
32853,8,623,3,39,98,771
31583,10,213,9,29,103,364
36349,5,96,1,19,26,147
524,297,24095,224,146,3767,28529
12481,62,1031,38,64,422,1617
38728,3,244,1,14,49,311
26261,8,36,4,50,77,175
48773,8,192,5,7,29,241
37801,7,75,3,23,46,154
47799,1,11,0,9,14,35
50151,2,32,0,1,7,42
31746,15,80,7,69,92,263
15875,28,179,15,102,271,595
49363,0,0,0,0,24432,24432
20453,10,51,6,50,72,189
39063,16203,42840,7554,34379,51073,152049
29617,17,1097,9,50,145,1318
10456,10207,78100,6495,11100,61069,166971
27467,13,127,4,65,58,267
30268,9,48,1,35,47,140
13495,23,1149,10,32,233,1447
1599,205,2778,180,226,1875,5264
20543,1054,28817,458,495,13962,44786
45758,1,4,0,10,19,34
458,279,4399,179,203,2811,7871
22959,15,69,7,52,112,255
16816,9,77,3,49,83,221
41663,2,56,2,16,20,96
37775,12,198,1,23,72,306
30403,9,197,1,23,52,282
8153,25,282,27,66,361,761
19481,14,432,4,23,93,566
24317,670,2437,330,246,1432,5115
41159,2,29,7,22,33,93
8416,22,210,12,67,180,491
4360,945,6347,463,370,2732,10857
32259,25,201,11,40,213,490
50062,4,98,0,3,22,127
37597,9849,80916,3328,6063,26200,126356
41833,10226,19082,1703,5180,22355,58546
8667,10,333,5,30,115,493
6075,42,398,36,110,495,1081
43983,2,36,1,18,23,80
8968,24,619,6,38,164,851
50407,0,0,0,0,3955,3955
35921,10,125,8,48,118,309
39469,7220,39797,2047,2293,31043,82400
48090,1,5,0,11,18,35
10391,133,5490,106,121,3188,9038
32646,20,68,10,48,79,225
41412,11,32,3,30,46,122
29744,7,158,2,27,26,220
41759,2,76,3,8,15,104
2418,7075,182346,2214,716,104295,296646
28479,530,28089,214,217,4077,33127
7211,24,63,6,82,150,325
35703,7,29,2,44,34,116
17419,250,4979,199,196,3219,8843
36091,5,171,1,14,27,218
3619,74,561,63,133,856,1687
28981,953,14064,591,2460,7201,25269
18341,12,71,2,60,77,222
110,1079,9164,924,908,5554,17629
29101,1991,58762,966,707,10255,72681
35403,13,255,4,33,54,359
35407,10,320,6,33,53,422
29715,93,178,63,211,2012,2557
130,1424,17071,1296,1298,10490,31579
40280,360,4109,201,104,4376,9150
9630,117,2262,103,113,1586,4181
27399,19,88,6,63,156,332
715,175,2670,109,118,1829,4901
31838,650,2585,168,294,2761,6458
33363,146,2444,65,84,1601,4340
5112,4711,73964,3886,9080,25083,116724
31166,22,112,9,36,197,376
29301,310,6763,148,90,6775,14086
31798,39475,392110,19319,26189,170955,648048
30312,9,55,5,47,54,170
1721,789,9118,760,1076,7297,19040
6833,17,906,5,54,144,1126
44042,19627,0,2044,1801,19421,42893
15841,1191,10101,567,438,3876,16173
33391,64,849,34,43,1355,2345
4439,92,607,61,147,773,1680
40983,72,171,28,161,318,750
33342,8,86,6,53,60,213
9959,48,285,26,55,1009,1423
19123,1293,42082,386,422,7727,51910
8533,54,692,35,43,1136,1960
38835,1082,7093,317,911,4737,14140
38705,17,69,13,62,249,410
22511,19,195,26,107,134,481
38749,2123,1915,296,1068,13966,19368
29087,478,459,258,290,1765,3250
17601,15,150,10,80,81,336
48000,49,40,18,31,211,349
32930,3669,55312,1462,728,13492,74663
1928,95,1890,59,71,1111,3226
3534,143,921,67,110,684,1925
12965,53,427,32,82,715,1309
50048,13,385,7,21,154,580
35848,5553,135098,1550,1013,86797,230011
2126,254,7099,195,183,4161,11892
1473,613,10099,375,313,7117,18517
51098,0,0,0,0,377,377
15717,88,1674,52,57,1218,3089
31157,1987,5307,1569,5478,10017,24358
36311,5,15,2,36,25,83
2556,180,2191,209,370,1092,4042
31827,366,1630,208,234,2730,5168
5957,738,20909,647,952,5349,28595
37639,7,131,1,16,40,195
2141,135,2267,78,83,3441,6004
49351,0,42,0,6,18,66
37224,708,1408,268,170,1313,3867
40299,7,47,6,25,56,141
4098,40,271,23,52,614,1000
40930,3645,17130,889,1112,15674,38450
34948,65,836,37,59,720,1717
28615,13,146,6,74,162,401
1591,548,5923,629,795,5127,13022
33669,31,668,20,75,260,1054
33302,249,5527,142,135,4756,10809
135,6229,68113,6939,7227,34814,123322
33842,10,45,5,45,52,157
36351,6,91,1,21,22,141
30202,4,178,4,41,52,279
28361,134,92,10,40,106,382
2541,140,1111,100,121,738,2210
39078,508,1734,130,241,1740,4353
30455,0,0,0,0,34976,34976
42935,15,476,3,15,98,607
10524,61,505,32,126,514,1238
38817,478,0,114,54,247,893
2676,57,4648,41,103,494,5343
18643,25,257,13,34,218,547
25833,87,384,44,79,1790,2384
2619,393,4880,390,629,1923,8215
8409,66,283,52,77,479,957
18001,6039,113540,4017,5427,22843,151866
3827,74,411,56,117,677,1335
38490,183,442,57,86,552,1320
50864,0,0,0,0,1184,1184
38986,7,607,7,27,105,753
49716,0,0,0,0,663,663
40102,876,21979,272,351,13029,36507
39617,114903,330596,22395,102393,200503,770790
22065,14,110,10,65,96,295
30851,37,255,20,109,242,663
36747,9,628,6,44,98,785
1241,298,17195,199,173,4052,21917
39987,181,1723,100,98,2863,4965
346,583,7045,482,679,5731,14520
34966,3567,21667,1460,2139,23598,52431
10321,7708,125635,4845,9589,36355,184132
25567,409,22697,247,415,5788,29556
334,3488,23332,3319,3435,15219,48793
40044,48,1510,33,64,1163,2818
1003,377,20561,365,215,4051,25569
49391,2,22,2,15,24,65
19857,550,3457,301,266,1696,6270
39569,2961,36626,1075,375,45426,86463
3704,99,230,87,206,341,963
33914,45,296,8,41,123,513
2336,117,7125,105,100,1750,9197
41072,12,272,6,15,127,432
38323,3,112,0,15,22,152
31050,356,8557,193,334,3278,12718
12673,513,30833,269,137,5860,37612
20207,26,240,24,47,335,672
37244,13,49,9,57,65,193
29661,7,311,5,33,70,426
35745,32,164,18,75,356,645
30483,32,168,31,63,438,732
1010,238,11480,180,119,3150,15167
19901,14,84,13,76,122,309
9790,2324,95797,1064,832,24151,124168
13091,8,200,10,39,67,324
13053,21,2600,21,44,265,2951
34372,8,92,6,33,65,204
36314,6,21,2,32,34,95
50066,8,241,10,11,94,364
37177,35,201,15,38,433,722
33534,11,185,2,30,65,293
2752,619,28796,303,267,4208,34193
6885,162,3825,125,92,1352,5556
38623,32,0,18,54,51,155
50172,3,0,6,1,151920,151930
42729,4,175,2,9,39,229
2163,858,12495,574,647,7205,21779
5874,11,512,5,37,100,665
32230,33,383,21,83,226,746
20225,19,172,10,55,211,467
11269,28,352,13,54,257,704
43465,1156,7815,450,368,2374,12163
4941,27,354,14,41,419,855
36356,7,104,2,25,44,182
15913,16,164,19,71,154,424
25619,7,61,5,56,52,181
9479,6630,56042,6233,15529,28772,113206
6448,46,236,46,150,261,739
34428,1919,32463,745,844,25590,61561
39947,5,119,2,11,28,165
4606,163,858,99,154,834,2108
39298,422,548,139,269,2431,3809
8100,1913,34678,827,491,29655,67564
10491,2437,54088,1692,2488,19280,79985
42442,7,184,4,7,20,222
31339,30223,292901,13684,18079,127649,482536
49420,5,316,2,6,25,354
5534,40,255,45,108,293,741
31810,1696,7286,788,589,3753,14112
49402,114,154,77,34,2865,3244
35321,616,14804,449,323,14485,30677
3599,103,798,54,65,933,1953
11889,329,15051,211,158,5616,21365
39456,10884,76498,3513,9939,34080,134914
20713,23,276,10,36,189,534
35567,675,4507,254,223,1230,6889
36712,11,183,2,42,90,328
3669,40,671,24,85,398,1218
3760,45,749,28,55,817,1694
43689,1,72,1,9,15,98
13479,93,1858,58,125,1619,3753
49292,4621,6518,849,6200,16818,35006
20189,30,234,16,51,241,572
30449,24,216,18,64,254,576
12959,855,5648,525,353,3069,10450
32684,97,2591,47,108,830,3673
38719,459,948,156,443,1689,3695
11375,314,10154,238,274,6145,17125
29179,4,177,2,35,34,252
2847,554,94072,256,276,4409,99567
37611,87,1171,43,125,461,1887
44544,4,39,3,22,32,100
32038,1913,12990,1177,1122,10473,27675
1822,334,2541,254,311,4525,7965
419,2141,30507,2721,3385,13606,52360
42958,2,58,2,9,18,89
41467,4,0,2,1,100580,100587
34122,9,160,2,17,46,234
43351,9,109,2,6,23,149
29759,11,50,4,60,52,177
50220,1,0,0,0,3900,3901
4186,10117,128398,6107,7370,43895,195887
18449,71,1475,53,87,972,2658
1423,101,3247,93,88,2030,5559
45757,2,5,0,10,20,37
50513,4,125,0,2,12,143
35398,15,184,11,48,54,312
1403,496,3206,300,242,1971,6215
9865,245,7817,188,185,4458,12893
10197,1209,17502,784,1897,4885,26277
7667,35,665,30,62,512,1304
10306,83,582,56,58,1069,1848
23819,21,91,7,45,196,360
29311,12,434,6,30,87,569
39507,2,9,3,25,23,62
40959,1339,1422,461,259,1312,4793
1792,665,3963,657,631,5502,11418
48543,161,66,25,44,181,477
43297,2,15,1,10,23,51
17389,4897,58138,1703,1535,30386,96659
16353,11276,86200,6836,7770,69760,181842
34851,17,193,5,38,146,399
37326,6,94,4,20,55,179
27969,1111,13321,514,402,19819,35167
33659,41,443,33,40,579,1136
39314,14,465,7,13,112,611
18759,15,145,11,70,137,378
33225,50,521,34,82,543,1230
30953,590,4357,655,396,4381,10379
2543,267,4864,269,341,1906,7647
49572,0,0,0,0,6093,6093
30965,23,114,7,71,169,384
4961,77,687,44,78,698,1584
43603,1,37,3,11,14,66
223,47855,715624,33398,29263,60016,886156
32618,6,242,1,23,35,307
215,100,1324,72,79,742,2317
40948,112,707,42,70,940,1871
1186,350,3948,341,507,3280,8426
37851,18,39,13,51,90,211
36383,6,96,0,19,27,148
6986,623,4088,365,261,2163,7500
36369,726,12335,265,159,8176,21661
49052,1,0,0,1,15558,15560
28809,41,284,32,65,526,948
37280,45,65,14,40,305,469
2501,102,517,127,232,612,1590
48851,1,22,4,15,36,78
26093,11,36,3,50,61,161
943,345,2986,426,646,3921,8324
19759,2228,51801,1041,875,16517,72462
2255,316,1253,234,221,2436,4460
1185,179,2826,161,230,1968,5364
21957,14,101,6,62,71,254
4926,70,1214,61,72,912,2329
553,2059,29683,1786,2325,15609,51462
21,1215737,23,232988,160297,187698,1796743
39214,3,169,2,20,23,217
25921,15,114,10,56,128,323
1940,230,4022,107,84,2431,6874
31747,24,261,14,91,118,508
37024,27,72,9,53,97,258
32219,28,361,8,37,165,599
39725,1688,3715,582,1393,6474,13852
2003,61,949,30,57,776,1873
5023,83,377,70,115,1044,1689
3107,256,2795,184,184,1118,4537
37190,7,65,3,23,30,128
6586,3768,47242,2778,3233,15301,72322
33824,7,23,2,45,45,122
45595,110,1,46,13,92,262
43398,4,90,1,5,16,116
35103,8,20,1,39,50,118
8431,40,364,24,39,398,865
39651,986,58752,426,155,14298,74617
33820,122,3573,79,254,2657,6685
6137,33,1971,5,28,412,2449
9708,109,2534,74,115,1634,4466
4910,96,7221,105,140,1945,9507
383,1041,13419,1387,1668,8540,26055
32796,13,39,4,54,61,171
39247,58540,203958,6847,3722,141415,414482
23121,4604,27689,3289,6874,21778,64234
48918,4,78,1,11,69,163
48972,2,73,2,7,21,105
33130,34,92,26,54,677,883
3810,45,720,47,133,402,1347
44063,7,81,4,18,49,159
17821,3238,24197,2230,4471,17384,51520
29619,9,747,7,37,101,901
19257,1780,10276,1759,6409,9176,29400
6680,30,1000,12,53,567,1662
16319,67,2837,48,75,856,3883
42156,25,422,10,15,140,612
21129,17,156,9,56,189,427
1329,101,1276,55,52,1750,3234
2701,15,85,9,66,88,263
32863,1908,38754,1220,756,19934,62572
7803,16,91,11,49,166,333
45196,321,870,29,71,310,1601
3844,49,227,25,114,386,801
37630,16,33,5,64,56,174
48759,104,176,22,45,397,744
179,84,3446,83,77,1560,5250
801,7894,123062,5941,2355,68556,207808
42464,2,23,3,17,54,99
41360,35,465,12,51,320,883
1425,3623,11139,2694,1106,11353,29915
5569,184,3330,68,232,1110,4924
32736,31,363,20,49,294,757
32153,511,15603,284,209,8157,24764
6634,2528,41157,1807,1466,18134,65092
40074,5453,14015,1626,17110,22941,61145
27569,16,158,7,63,82,326
43450,0,5,0,7,13,25
39345,4,48,3,23,38,116
10189,404,16790,304,263,7120,24881
39760,35,385,13,26,291,750
7162,46,308,32,92,245,723
18039,954,20292,379,399,6344,28368
32860,8,126,2,17,45,198
10790,10336,281161,6195,5992,49231,352915
25541,15,166,8,47,154,390
2165,325,1407,341,411,2348,4832
3932,65,329,63,112,475,1044
50275,1,1,0,0,31244,31246
48814,2,111,4,6,39,162
42563,6,146,3,6,21,182
49615,1,23,2,15,31,72
9955,9,74,6,63,74,226
15043,506,4192,321,487,4514,10020
1905,90,1352,58,88,1040,2628
22671,19,211,10,64,192,496
45911,1,5,1,10,18,35
37922,118,860,57,79,1243,2357
10431,366,19569,290,260,6158,26643
19907,19,68,8,49,195,339
420,501,14835,240,192,7288,23056
36018,32,131,12,74,261,510
37241,21,43,9,55,58,186
1059,56,1818,44,103,707,2728
35002,15,105,8,66,60,254
22759,616,20819,365,189,7907,29896
16820,11,59,4,55,74,203
23187,17,106,29,110,116,378
2822,31,356,30,94,194,705
11371,2091,39608,1361,1409,11151,55620
36296,30675,255279,11458,9512,120752,427676
31699,30,155,18,101,227,531
48502,0,0,0,0,1531,1531
23421,8561,97720,6277,5933,37272,155763
43015,18,86,23,44,107,278
33060,8,55,2,46,34,145
32866,3554,23817,1786,3560,21065,53782
15389,39,580,24,60,311,1014
31678,139,1594,81,84,2171,4069
45532,2,17,0,9,16,44
35552,419,1,305,172,539,1436
1773,272,6399,152,120,3483,10426
10445,146,9078,53,65,1677,11019
33764,29,149,10,57,125,370
9442,835,6219,479,361,2036,9930
3890,95,693,50,93,460,1391
2566,42,361,41,129,252,825
11541,89,172,128,194,415,998
33253,9720,200681,4770,4726,42899,262796
40710,4,195,2,5,24,230
31848,2912,41602,1231,2610,12069,60424
29711,9,83,8,43,63,206
50582,0,0,0,0,1937,1937
22391,12,56,10,75,70,223
303,588,13436,877,1233,4833,20967
278,469,5735,665,1236,2471,10576
41188,80,844,61,77,1039,2101
39823,169,177,26,75,540,987
2114,76,857,39,66,744,1782
18953,53,1820,19,41,522,2455
36402,5,91,3,27,43,169
47158,0,0,0,0,17886,17886
30533,220,8499,87,139,1905,10850
31501,12,636,5,27,57,737
34673,8,31,3,22,56,120
36096,7,282,6,16,39,350
228,20777,140082,19917,19366,121474,321616
34905,141,251,51,218,874,1535
11033,142,10846,72,122,1638,12820
37472,10,50,8,55,125,248
31344,191,3807,159,217,3393,7767
6055,205,821,119,173,1575,2893
9777,51,1342,22,58,618,2091
32148,20,153,8,65,127,373
41611,805,6683,216,164,5852,13720
36223,121,1161,53,67,1190,2592
31509,6,43,2,36,39,126
15195,2799,45128,1975,1723,15220,66845
1328,96,2316,48,58,1391,3909
15823,12,202,9,69,165,457
39183,227,409,136,305,902,1979
19337,18,242,12,66,194,532
7596,829,17303,496,658,9426,28712
49984,0,0,0,0,87,87
35723,15,70,7,51,124,267
11001,718,10338,326,263,10355,22000
36817,10166,59488,3593,6842,45856,125945
3215,89,1853,58,85,1884,3969
4260,107,673,61,101,431,1373
38045,8,389,9,31,94,531
33175,11,53,2,37,72,175
6361,446,18572,363,222,9714,29317
9863,18288,78607,16951,15634,76656,206136
50411,283,0,19,43,351,696
40242,0,0,0,0,573,573
33357,190,258,82,99,716,1345
31644,6,268,1,28,43,346
36359,7,93,1,13,25,139
10298,1256,69458,655,404,15897,87670
29886,16,59,4,52,116,247
27551,15,72,11,57,78,233
38009,766,3697,358,1057,3679,9557
42146,5,28,6,32,88,159
15915,28,119,11,68,224,450
2162,588,2517,616,929,4026,8676
50587,0,0,0,0,9940,9940
6033,16585,262785,9667,12078,28238,329353
25073,13,118,8,54,139,332
1505,430,39276,214,221,3530,43671
5019,95,2778,83,81,1782,4819
4966,20,1865,14,39,227,2165
24719,50,170,16,58,435,729
34747,1034,5390,469,380,2371,9644
49703,1,0,0,0,6173,6174
29936,100,239,37,99,498,973
49133,1,15,2,20,22,60
41471,196,239,137,32,8823,9427
33997,133,1908,75,115,1694,3925
33564,305,2999,107,179,4004,7594
9346,211,1723,105,243,1295,3577
29782,15,252,8,47,139,461
7376,26,310,19,58,334,747
21751,1113,7488,512,417,2422,11952
191,392,49529,330,194,5011,55456
1450,537,3323,523,504,6626,11513
2688,282,1341,262,291,2569,4745
6050,1389,12150,659,430,8415,23043
48295,1,6,0,9,17,33
22131,12,46,4,55,75,192
8110,1206,9492,694,495,4129,16016
46422,0,0,0,0,4141,4141
48614,1353,78230,490,690,37067,117830
10045,25,118,16,59,341,559
39408,2,14,2,37,30,85
50267,2015,417,117,312,2395,5256
37827,10,24,6,39,187,266
49165,147,1537,48,114,2177,4023
15957,10,75,13,80,106,284
30177,13,312,6,60,96,487
269,270781,781007,157576,196364,189903,1595631
44513,125,503,24,72,265,989
8525,21851,393679,14310,16856,123484,570180
1661,842,4180,935,906,7731,14594
30585,883,19627,389,149,13968,35016
800,1335,10993,1213,1320,16769,31630
8995,883,12682,543,265,8347,22720
5585,115,1012,46,44,1042,2259
38815,373,41411,132,114,3620,45650
17535,1146,66821,596,406,13330,82299
30673,13,212,1,37,139,402
22573,12,154,4,42,96,308
19687,23,193,13,50,227,506
23185,17,97,26,110,105,355
3043,98,3077,49,101,1517,4842
30386,49,223,37,101,767,1177
4113,70,528,75,154,787,1614
32267,483,5771,296,249,1417,8216
36731,15,197,2,28,99,341
30241,7,199,2,21,34,263
40682,15859,15001,2195,1170,28839,63064
15037,8324,257321,4259,6239,59843,335986
3692,442,4882,349,317,3014,9004
38416,147,85,44,69,863,1208
2146,51,1184,40,64,655,1994
42246,3,180,2,20,63,268
33032,856,22156,322,313,7003,30650
35059,9,24,2,39,57,131
50429,0,0,0,0,347,347
30933,7,30,2,54,41,134
2572,80,1691,96,222,783,2872
5455,500,2471,278,198,1470,4917
31448,283,7101,209,213,3257,11063
42004,100,92,38,39,373,642
24575,21,146,26,126,115,434
32288,13,622,4,29,82,750
2951,725,39023,423,336,10264,50771
28817,5396,42166,3517,6156,25934,83169
42433,7,157,5,5,19,193
43639,0,25,1,4,7,37
40238,14,134,6,37,241,432
26275,9,36,3,49,74,171
2617,170,3260,129,113,2879,6551
2964,1229,13788,1218,1828,10458,28521
4603,105,681,63,86,561,1496
23775,1808,67513,1011,1147,29550,101029
256,2425,92732,1096,717,45251,142221
34892,18,105,9,33,127,292
3889,253,4366,97,125,2558,7399
46705,1,3,0,11,18,33
10420,491,2439,298,202,1473,4903
33290,25,72,11,93,134,335
31672,9,60,4,68,65,206
44061,67,2116,31,45,523,2782
37750,13,93,7,54,98,265
37888,76,138,31,65,356,666
33042,29,682,8,40,196,955
36992,611,15116,223,206,11346,27502
36702,1366,26245,701,684,25578,54574
14645,1974,33622,1378,1750,10481,49205
32900,4077,109467,1413,705,47929,163591
43797,0,7,1,6,9,23
30519,74,350,43,143,695,1305
47761,0,5,0,8,11,24
38078,28,308,8,25,289,658
3034,221,1755,151,154,972,3253
37165,9,51,4,36,81,181
35033,12,151,2,38,70,273
6310,35,561,23,65,406,1090
13927,90,1187,53,66,1191,2587
31563,17,128,5,51,167,368
2233,65,510,55,102,372,1104
9130,2398,51715,1161,928,11194,67396
9395,78,647,62,156,519,1462
37522,8060,24582,3822,13650,35248,85362
5653,271,1777,138,141,1126,3453
42206,471,1800,137,122,2372,4902
1637,231,8621,114,173,4053,13192
59,17092,292937,19444,24171,87303,440947
13215,161,2445,99,104,2773,5582
48055,3,0,1,9,15,28
4398,37,2296,22,69,730,3154
41655,5,64,1,14,33,117
30957,17,108,22,116,95,358
42104,5,329,3,7,46,390
28017,6,34,2,53,38,133
41309,4,130,1,4,17,156
29637,9,305,8,39,94,455
38759,26933,172122,11965,16933,69780,297733
16908,20,74,9,81,110,294
30743,22,227,4,50,247,550
1072,1217,18503,1426,853,13652,35651
49211,292,1300,42,74,1155,2863
506,343,3052,358,419,3839,8011
1127,888,9111,744,988,6726,18457
37682,385,8399,167,106,5725,14782
36290,199,711,73,98,937,2018
626,453,3259,452,539,3040,7743
15989,435,9839,223,134,2697,13328
122,4236,55849,5074,5842,28452,99453
22173,10,720,7,34,108,879
35061,6,22,2,38,38,106
38939,748,15665,411,393,10051,27268
33808,143,862,83,131,2301,3520
3712,8237,348311,4859,5066,41342,407815
41684,2,86,2,10,18,118
9117,1102,39900,740,476,11196,53414
2532,320,1838,179,182,1267,3786
2679,83,570,56,105,722,1536
37857,47,447,14,15,419,942
33795,555,7904,287,442,2679,11867
3776,40,437,39,93,237,846
36229,13,241,5,27,86,372
37879,218,1824,39,62,1281,3424
35815,806,19146,469,523,9271,30215
35168,7,21,1,39,34,102
16385,2655,44259,1738,2099,17213,67964
6325,1468,160170,721,468,14988,177815
39273,7,121,1,16,51,196
36501,263,5387,98,162,2561,8471
28099,10,69,6,45,74,204
1065,2034,10179,1706,1271,15775,30965
12149,2218,33748,1869,3281,16738,57854
43221,1,4,3,12,10,30
36630,11,823,4,11,76,925
49533,0,0,0,0,1430,1430
17969,113,226,83,142,665,1229
16646,93,1610,68,94,1135,3000
36370,485,11319,190,157,6235,18386
19023,2667,21580,1916,3345,20795,50303
1411,112,1241,78,124,849,2404
7396,359,11025,254,182,5154,16974
7088,16254,368127,7183,12332,60202,464098
2105,1125,4526,1206,1774,9962,18593
27453,10,140,9,50,55,264
6674,46,278,31,105,444,904
2943,421,2531,234,231,1466,4883
12563,37,317,28,84,212,678
38319,3,79,2,18,21,123
42317,15,482,4,25,91,617
1647,353,4743,152,311,4357,9916
36355,8,66,2,20,28,124
405,1413,74600,736,625,22977,100351
37475,20463,179611,7512,10194,81561,299341
23723,21,70,7,45,194,337
43799,0,9,2,5,10,26
32842,28,69,9,80,121,307
38551,3,296,3,17,60,379
2789,348,9094,380,1087,1358,12267
38899,85,281,37,61,681,1145
32936,8069,52949,3113,8817,27308,100256
37370,295,6734,83,151,2177,9440
30090,11,196,1,48,68,324
41509,9,53,4,50,61,177
49277,13,0,7,17,81,118
41290,245,5594,101,68,6826,12834
266,669,7690,482,592,5645,15078
5085,120,4822,51,119,2125,7237
44084,5,192,2,4,33,236
37055,4990,145736,1624,726,64694,217770
3153,52,673,37,86,684,1532
5281,255,1900,160,143,927,3385
45584,8,68,3,13,97,189
11785,18035,177741,11441,15850,99788,322855
40557,8,466,5,7,52,538
36403,8,152,0,16,26,202
36115,10,215,2,15,45,287
35404,8,319,6,38,77,448
4220,11,151,7,41,166,376
40147,23,738,12,32,241,1046
3701,6498,44324,4594,3171,72892,131479
18081,12,140,5,44,87,288
30831,72289,1329174,26670,28452,186846,1643431
6774,4410,25259,3668,3645,46283,83265
5645,165,817,97,121,828,2028
41440,85,33,25,136,458,737
2206,50,1860,59,61,963,2993
39154,4,38,4,21,57,124
50398,44,0,4,9,40,97
36052,1183,4012,502,335,2065,8097
25173,11,296,8,55,108,478
50654,0,0,0,0,758,758
37554,10,57,8,47,68,190
40817,5,137,2,7,34,185
3558,156,974,88,153,1135,2506
48919,1,54,0,12,34,101
23459,443,12609,218,115,5423,18808
34126,5689,62352,2856,3814,28565,103276
32628,13,71,5,46,94,229
38798,441,3360,223,217,992,5233
36875,117,2251,38,72,918,3396
31005,10,39,2,44,59,154
9849,580,5085,293,275,2031,8264
32777,5,180,2,20,28,235
7445,10,533,6,30,100,679
42733,2,66,3,7,15,93
3424,134,535,131,155,1752,2707
10710,54,1074,41,63,1115,2347
32353,720,1,370,664,866,2621
40463,2,91,1,13,20,127
26227,11,35,2,42,57,147
40335,257,615,109,95,5465,6541
43317,0,5,0,11,13,29
10889,25,115,19,86,178,423
19213,17,833,12,31,226,1119
17741,6897,73413,3759,5803,48815,138687
7022,14,945,11,49,177,1196
33079,12,49,4,51,108,224
1532,1680,30152,1380,2325,11194,46731
37264,410,5399,195,249,4193,10446
39429,95,738,77,64,1329,2303
30771,73,3785,23,41,789,4711
38333,547,12156,252,148,7892,20995
29948,6,73,7,81,76,243
7723,123,1684,65,150,1017,3039
43340,0,18,1,4,8,31
49748,3,58,1,4,11,77
42667,6,12,4,15,72,109
38086,1175,13234,555,157,33575,48696
35149,9,50,1,44,38,142
34513,557,8149,210,204,12297,21417
16832,10,49,5,49,75,188
33912,21,652,23,69,342,1107
32875,13,406,4,37,91,551
31263,11,427,6,33,171,648
28097,13,78,5,45,105,246
38445,4,212,2,15,29,262
8365,62,2168,46,93,612,2981
39159,3,25,5,29,34,96
194,997,23297,718,483,10257,35752
35163,7,27,3,38,35,110
23199,20572,300743,13151,6977,96136,437579
7908,73,290,42,77,356,838
39364,26,31,16,12,266,351
505,601,4678,686,736,3671,10372
43354,0,7,1,6,15,29
2529,54,929,37,42,644,1706
16916,1220,79055,416,343,11775,92809
26311,9,101,2,45,59,216
9366,1574,96036,760,409,18804,117583
2858,506,3744,268,254,1963,6735
23233,28993,427262,12371,24683,91379,584688
37989,8978,103764,3870,1900,35279,153791
1164,946,10445,903,816,6522,19632
36353,7,73,2,26,25,133
12783,1639,54974,862,639,28901,87015
40530,29766,150403,6343,11849,71323,269684
810,144,1247,165,264,1357,3177
49204,328,0,72,168,2001,2569
28831,17,511,5,39,228,800
32360,11760,84714,4835,11662,54539,167510
34877,22,138,11,44,229,444
8626,57,4407,17,45,472,4998
2839,59,709,44,74,823,1709
33218,964,7825,512,277,23145,32723
8495,19,115,15,45,328,522
12745,74,860,34,68,984,2020
43470,0,0,2,2,50570,50574
43682,1,72,4,9,17,103
22071,574,33108,303,138,7436,41559
12399,23,214,9,39,264,549
44840,1,14,1,21,20,57
31017,9,47,2,69,89,216
34284,2108,17796,947,978,17281,39110
10397,6321,92197,3210,4439,37157,143324
32323,5746,33350,2183,3481,26826,71586
32813,10,882,3,40,82,1017
12791,17,102,10,61,252,442
39709,136,723,90,62,1718,2729
40316,19,7,8,48,75,157
29247,11,162,6,35,107,321
12027,27,274,24,90,472,887
40323,639,5365,220,161,6195,12580
41279,3,159,2,9,41,214
6901,191,1437,93,191,1077,2989
20815,696,27438,244,355,8207,36940
34490,18,64,6,56,116,260
3000,530,3697,512,465,3531,8735
13839,120,7830,99,130,1947,10126
25777,80789,1949561,16503,14148,161035,2222036
40594,31284,121759,5073,18061,37591,213768
35798,478,18405,178,186,4959,24206
5575,49,359,33,74,270,785
35774,87,702,48,72,1446,2355
10701,29,316,14,54,183,596
3180,21,180,11,71,142,425
38023,18,182,6,46,86,338
4578,73,693,48,96,962,1872
36240,176,4113,95,122,2137,6643
31033,19,118,5,68,108,318
39354,2,44,8,33,62,149
39127,2,22,1,26,32,83
8526,46,1368,15,37,588,2054
14175,2746,42073,1084,487,34359,80749
23779,18,122,11,76,194,421
12157,556,2824,471,410,1976,6237
40136,1895,6501,850,3005,5842,18093
24989,31,164,17,73,217,502
50075,0,65,0,6,16,87
3511,64,1169,24,44,625,1926
40360,4,469,6,16,66,561
12143,1127,9116,509,433,3712,14897
10247,12,84,7,53,74,230
22345,23,231,7,55,115,431
1205,412,13722,286,233,9276,23929
6291,541,26716,365,234,9035,36891
8332,9,196,4,28,84,321
1736,117,3144,122,118,1068,4569
35912,10,51,3,40,62,166
40291,21,767,11,33,138,970
41781,136,1685,82,47,3063,5013
36097,13,251,1,21,69,355
1726,10419,197172,8864,12600,53583,282638
35563,18,40,7,38,147,250
40089,188,17,7,129,105,446
11733,21,80,10,74,124,309
19217,10,810,5,34,140,999
34834,1933,10246,905,2256,10865,26205
3425,78,415,60,89,701,1343
40827,4,112,4,7,26,153
20929,18,1344,5,28,160,1555
35721,9,46,3,50,48,156
14345,23619,574724,12924,21200,141077,773544
4399,900,4575,474,410,3434,9793
4095,67,2800,48,49,1650,4614
20555,5481,32151,4007,10388,26012,78039
40389,124,233,60,29,3477,3923
13073,89,3025,65,101,1175,4455
34207,22,38,8,69,78,215
23777,2117,65895,1065,1227,34185,104489
279,1792,10383,1365,1246,18893,33679
48556,84549,128861,11903,21696,123063,370072
32197,12,71,8,64,79,234
49114,61400,32,1469,694,66144,129739
1180,562,3300,490,512,4528,9392
6151,332,17449,217,139,6648,24785
26281,9,38,3,43,100,193
18527,16,102,5,52,121,296
2740,103,367,57,137,745,1409
30669,8,237,5,35,63,348
36622,13,199,2,29,75,318
48963,2,72,1,3,14,92
19987,21,75,12,80,109,297
28579,8,91,3,51,58,211
28387,10050,74696,5190,7305,54982,152223
10815,25,137,10,86,186,444
42228,7,130,2,14,88,241
38060,7,59,7,40,148,261
50644,11,34,3,13,32,93
9507,55,325,31,86,280,777
30530,6,54,2,48,57,167
5607,78,337,44,77,331,867
6172,373,18984,181,143,6237,25918
8139,41,400,20,93,187,741
33153,684,2971,307,284,1369,5615
23587,4792,33460,2903,3003,25376,69534
36947,11,63,5,44,74,197
51056,1,34,0,1,7,43
14563,387,1723,333,578,2184,5205
44191,2518,1454,521,539,3374,8406
33538,37,56,10,80,303,486
44064,791,1168,96,243,2664,4962
41632,148,209,43,99,697,1196
47270,0,10,1,10,17,38
33320,6,30,2,34,54,126
36601,15,724,6,14,116,875
2059,64,664,51,87,742,1608
33986,43,118,17,60,367,605
48926,130609,246711,12807,12547,149479,552153
36655,863,2779,307,1874,4440,10263
23895,21,378,8,54,238,699
39275,8,152,3,10,34,207
28631,23,364,2,33,115,537
32051,609,26019,306,236,5565,32735
48003,0,6,1,13,14,34
17048,8,279,12,36,138,473
32817,82,1899,64,77,1010,3132
32295,16,535,5,43,114,713
1651,273,3350,203,194,3436,7456
23787,617,5717,500,1150,3102,11086
35408,10,346,2,30,60,448
461,638,61165,406,295,7804,70308
1273,258,2590,173,196,1277,4494
11469,342,1942,163,213,1170,3830
35394,10,252,5,32,96,395
37563,1055,1691,449,471,5104,8770
26103,10,30,3,46,65,154
31692,12,35,4,38,44,133
7071,13,734,5,43,93,888
7048,70,821,48,153,419,1511
7664,28,653,9,65,282,1037
10207,34,637,23,36,506,1236
49498,1,44,0,3,14,62
15729,1314,30534,653,580,8289,41370
558,1232,55452,575,585,7332,65176
2819,368,1611,290,285,2849,5403
37228,7,39,6,20,48,120
35213,0,0,0,0,340,340
50608,0,0,1,0,64152,64153
5304,81,1186,65,236,635,2203
20673,638,10591,266,122,10242,21859
1245,263,4514,110,88,3518,8493
39277,162,1088,94,168,858,2370
41372,4483,12505,1582,4762,16182,39514
31483,1333,51864,625,333,14944,69099
30790,222,5979,129,156,2881,9367
366,1215,17095,856,1491,9332,29989
30524,1651,14364,970,3745,10228,30958
4556,102,490,55,85,460,1192
33881,20,178,13,50,206,467
4840,166,821,93,105,678,1863
32321,160,2397,92,86,2138,4873
22695,200,8496,169,194,2715,11774
40397,17777,84141,5289,6523,47605,161335
50784,2,47,0,1,6,56
40763,1008,4553,397,872,5945,12775
4730,764,1756,188,211,1738,4657
35052,8,21,1,38,39,107
19523,354,1436,161,154,870,2975
25999,159,1282,97,145,1321,3004
21431,13563,198119,7460,11938,76989,308069
41285,94,1409,39,95,915,2552
3026,78,1080,58,81,979,2276
8655,555,4354,314,304,1819,7346
42331,13,17,9,44,228,311
9288,110,4595,72,130,1539,6446
9028,36,155,17,78,207,493
36492,1664,2485,483,254,5612,10498
14713,22870,381475,11146,10659,123960,550110
37002,27,21,12,66,101,227
40174,19190,69068,4595,3561,73058,169472
33234,9,88,7,40,84,228
5869,15,904,5,46,136,1106
4681,29,399,15,55,376,874
27557,20,102,8,58,176,364
38504,4,116,0,9,20,149
14693,168,3391,105,132,900,4696
7662,6562,65480,4601,5445,41598,123686
30071,6,130,4,40,58,238
5865,49,1153,31,38,567,1838
12677,715,7725,644,1343,4050,14477
9119,26,445,17,109,166,763
18475,19,60,6,51,108,244
43266,0,10,2,6,10,28
5993,334,1818,195,191,1130,3668
6381,2688,51548,1679,1602,20749,78266
4331,62,209,43,193,189,696
2655,68,6499,54,111,654,7386
42147,13,0,8,36,54,111
3490,34,834,14,38,466,1386
412,2560,46139,2852,4739,16608,72898
6397,34,289,29,104,223,679
6919,1325,14190,989,2317,5985,24806
42798,196,3597,91,94,5079,9057
4334,2396,15041,2478,5597,11255,36767
36399,9,105,2,27,27,170
35339,13,152,3,16,35,219
9471,1678,98464,839,609,16265,117855
29365,7,31,2,41,57,138
43410,0,12,2,6,11,31
3108,231,1353,130,131,794,2639
4054,29,376,24,97,217,743
18005,19,135,16,71,139,380
3553,101,654,59,104,520,1438
38707,2705,10008,1328,4985,11311,30337
37136,3,79,0,8,21,111
48321,1,10,1,17,25,54
212,381,9585,195,175,6555,16891
34937,371,3166,193,162,1003,4895
37552,11,177,3,20,83,294
30289,18,268,10,44,143,483
9718,303,1624,205,171,1051,3354
39957,8,214,4,15,90,331
34665,13,58,3,48,40,162
3817,31,309,13,40,329,722
36963,935,6023,429,343,4529,12259
10582,788,26648,355,290,6572,34653
34198,24,166,23,64,239,516
22615,10,133,6,41,92,282
37359,33,31,14,105,193,376
49475,0,53,0,2,7,62
35492,23,493,5,46,80,647
23831,329,7597,281,303,5621,14131
36933,1015,4297,361,294,1470,7437
34183,9,31,2,43,36,121
22159,11,334,9,37,89,480
667,1862,27082,1653,2594,13259,46450
22657,14,103,7,43,76,243
1752,62,2151,43,72,852,3180
49835,0,0,0,0,896,896
36267,2698,10451,971,3197,8406,25723
29653,7,205,3,40,68,323
2668,46,3258,45,106,543,3998
30045,15,369,7,53,93,537
3836,96,1374,96,195,911,2672
49866,281,1430,145,41,4916,6813
18357,13,102,8,64,94,281
36678,6,132,1,12,30,181
48049,0,4,0,10,14,28
31117,872,8104,455,427,2595,12453
37878,5,25,5,35,89,159
3028,49,426,44,62,703,1284
4908,177,1607,148,340,2103,4375
27571,10,90,3,59,75,237
41462,92,303,74,38,3765,4272
50208,0,0,0,0,232,232
34443,26087,191213,10554,14993,49805,292652
29173,18,462,4,35,112,631
44011,1,16,1,20,24,62
39224,6,185,4,19,82,296
27855,8,52,4,50,62,176
16474,958,5126,492,342,2645,9563
10595,75,241,58,88,1605,2067
23737,77,86,72,121,196,552
788,931,18186,398,1096,7150,27761
5031,117,2401,70,74,1261,3923
38861,4,53,2,32,41,132
34426,7,90,3,24,35,159
3923,53,665,36,69,393,1216
5624,61,3012,47,58,1018,4196
9969,32179,232130,12941,8532,166335,452117
21001,1300,6244,572,380,2832,11328
45649,0,0,0,0,5631,5631
32924,9804,44019,5105,9146,51093,119167
7062,813,15717,611,459,7528,25128
37219,4,60,4,42,39,149
19587,12,147,9,53,148,369
38577,0,0,0,0,982,982
7377,65,2828,44,63,1202,4202
17439,12,124,11,70,163,380
34311,402,3328,203,219,1096,5248
5973,1614,17319,1111,2051,9439,31534
6000,39,391,21,37,525,1013
7810,32,768,14,39,388,1241
44067,168,416,44,53,1298,1979
29555,10,255,4,39,59,367
2473,114,1864,67,91,1517,3653
34324,71,1544,26,47,473,2161
37441,1577,40484,757,298,30870,73986
3724,73,330,63,103,352,921
39607,1508,83271,356,437,11599,97171
10758,20,209,26,111,172,538
48583,434956,352,4131,1791,257991,699221
27737,362,1340,205,431,1218,3556
11659,40,729,38,74,583,1464
32620,727,6410,376,302,2482,10297
29325,1988,18199,1337,1450,16823,39797
7791,35667,408283,25397,17808,119153,606308
15119,8996,46660,5042,9017,52915,122630
38268,1148,4840,386,685,8495,15554
2129,6786,117967,4281,4438,68522,201994
1139,35,348,28,96,238,745
42238,873,11503,266,160,7583,20385
36431,2221,24191,787,1203,15299,43701
2584,78,2036,40,64,908,3126
29949,313,12586,49,192,1575,14715
28987,16,262,7,24,80,389
7666,47,1181,35,67,614,1944
21475,19,119,7,52,95,292
43652,0,19,1,7,8,35
181,899,41925,750,648,5953,50175
4639,311,2162,220,214,4153,7060
6993,34,1214,13,55,335,1651
2174,230,5586,132,128,2955,9031
23903,17,645,7,37,234,940
30103,44,1015,29,58,493,1639
3037,112,1465,66,66,1101,2810
50441,93,0,4,12,134,243
25987,18,62,7,52,178,317
40148,3024,15250,1385,3435,15955,39049
43501,0,10,0,6,14,30
39107,17,172,10,30,196,425
22755,19,95,7,88,118,327
11711,8,42,4,48,55,157
49900,0,57,0,3,14,74
1488,467,6827,332,243,7650,15519
32615,45454,506169,21189,25588,157207,755607
2035,720,14196,500,410,7878,23704
33263,8109,31657,3989,2194,45298,91247
35976,12,140,2,18,64,236
1642,2032,19905,2037,2060,9550,35584
37440,1808,44980,869,343,39657,87657
50010,0,0,0,0,756,756
42808,4523,0,135,300,3781,8739
34125,719,11478,412,147,5516,18272
18099,686,16074,333,407,4007,21507
41785,117,760,31,65,507,1480
109,2947,35748,3640,4650,18582,65567
3600,81,784,48,76,1140,2129
43381,0,7,1,13,14,35
5290,101,3374,74,100,1113,4762
38976,12,181,5,21,72,291
3248,106,1208,133,107,1159,2713
41564,13,451,9,39,152,664
7254,102,1086,53,80,1371,2692
43299,89683,274489,23088,22956,189895,600111
25271,53,2320,19,30,591,3013
22385,13,669,2,33,106,823
15453,84,2754,53,72,1248,4211
30378,14,88,6,47,227,382
50022,2,95,0,2,16,115
30484,63289,394076,23647,15265,239544,735821
35678,1070,25224,488,212,24651,51645
40462,63,766,32,80,729,1670
14811,7537,91869,4462,5401,51608,160877
41529,72,103,17,139,340,671
42984,401,21072,75,125,2166,23839
17917,298,2297,199,288,1242,4324
39430,7,71,5,51,90,224
32221,13,159,7,70,57,306
32904,7,48,5,37,39,136
2707,76,455,59,122,380,1092
48054,0,3,0,11,12,26
42639,2,65,3,5,14,89
3702,6473,121187,4636,5069,55634,192999
3355,47,293,35,87,557,1019
42324,278,3208,171,158,1053,4868
42498,1577,4089,143,215,2156,8180
33578,28,321,14,39,226,628
19063,17,71,8,56,134,286
160,5099,43522,3610,2755,67847,122833
5664,95,480,55,81,392,1103
36309,2073,6322,889,3054,10493,22831
49090,10,228,7,3,109,357
50059,6,187,5,6,37,241
34931,20,67,4,36,61,188
40523,4,160,0,9,24,197
1035,197,1307,206,350,1549,3609
39490,55,1092,9,26,330,1512
36286,4790,165768,1611,810,76042,249021
4491,366,3935,242,222,1356,6121
20529,9,174,7,25,73,288
39585,151,1748,92,93,6505,8589
43312,0,4,0,7,15,26
35495,8,46,1,26,60,141
1962,101,637,63,121,915,1837
129,2977,23632,3355,3266,17266,50496
8039,838,5000,454,308,2469,9069
32857,7,128,0,14,33,182
41022,8,272,5,5,27,317
30428,5,423,4,21,48,501
42913,77,843,39,49,867,1875
11829,48,339,21,75,237,720
274,1656,23289,2006,2553,13257,42761
37852,18,64,4,44,71,201
42826,16634,68413,3231,7049,32295,127622
20083,25,103,12,68,175,383
44055,45050,16,1004,1657,41006,88733
49144,1,11,1,17,40,70
23385,2006,83661,931,350,27425,114373
12163,25,247,42,59,511,884
50923,0,0,0,0,1163,1163
31761,17,524,3,28,94,666
29727,22,70,7,42,277,418
49774,0,0,0,0,310,310
22981,20,110,9,53,175,367
2173,27,202,19,49,221,518
38068,132,2633,77,113,2166,5121
3921,142,1094,93,113,583,2025
48626,487,4772,260,179,1342,7040
30081,6,237,2,31,26,302
39643,306,1015,139,165,1110,2735
31289,662,27473,315,246,5044,33740
34742,889,15097,458,531,5560,22535
48858,4180,6583,746,2183,15080,28772
31202,21,362,17,67,274,741
23319,1741,24518,1056,363,10398,38076
42392,835,5395,395,218,14441,21284
7170,56,975,31,51,1066,2179
50207,429,0,29,32,351,841
41101,18,41,10,57,141,267
31941,76,541,42,88,1189,1936
17471,11,73,5,56,72,217
33069,322,11368,171,131,5020,17012
33539,13,41,3,45,57,159
17549,24041,184241,14124,9930,143908,376244
49895,33,1215,24,20,344,1636
9292,11,158,8,45,166,388
34009,3292,31037,1544,4385,16195,56453
15315,19745,375108,10048,12214,107646,524761
2525,237,2266,133,213,2156,5005
28185,13,116,6,48,93,276
23031,21,71,12,52,230,386
42183,26,59,8,23,83,199
43817,0,10,2,5,9,26
50082,0,49,1,4,11,65
38379,10,128,4,47,46,235
38610,18888,126892,6609,17405,61198,230992
17217,19,62,10,50,214,355
2508,2060,54499,1833,1345,17705,77442
217,234,1249,124,155,998,2760
30442,17,147,4,56,95,319
5240,22,120,14,56,445,657
11031,548,3286,298,240,1612,5984
21065,23,1000,8,45,204,1280
1823,250,2760,187,211,2271,5679
35084,6,29,2,36,44,117
21809,4660,27617,2602,7472,20930,63281
26197,10,56,5,50,123,244
25441,86,673,71,85,909,1824
39407,2,8,3,29,26,68
14527,4261,92029,2503,2350,28373,129516
19099,88,6065,85,113,1500,7851
37175,1368,5924,474,516,7625,15907
21189,469,15525,223,203,5595,22015
6437,118,1058,94,101,822,2193
6980,1004,5191,901,1254,6607,14957
17901,234,13693,117,164,2667,16875
26341,8,50,4,47,50,159
48884,1,7,1,14,29,52
5207,16,160,11,48,113,348
3220,1045,14339,456,392,17249,33481
36095,8,210,3,15,40,276
36023,28046,80094,12556,28609,70394,219699
29712,11,53,8,48,100,220
1083,159,911,151,173,2091,3485
6068,71,1232,56,62,734,2155
27459,13,198,9,75,73,368
28713,511,13789,208,190,5485,20183
11525,22,84,11,66,157,340
35956,12,49,3,39,53,156
41076,25,66,13,11,214,329
37384,6,349,5,19,70,449
43596,0,17,0,4,8,29
43519,0,11,0,6,14,31
20745,600,37884,296,220,7453,46453
31873,12,166,2,27,54,261
3953,157,1146,88,138,821,2350
9498,20,86,8,42,146,302
50002,0,1,0,0,4441,4442
32698,3538,74208,1377,627,17123,96873
9135,2141,127363,1497,876,36732,168609
15095,55,758,39,59,841,1752
49771,3,162,7,13,66,251
38853,8891,10953,1451,27414,22824,71533
10108,780,11602,773,860,7566,21581
29835,10,127,4,72,98,311
5337,1353,49961,848,1975,3630,57767
42971,1,62,1,7,12,83
47162,1,0,1,1,13870,13873
16001,3997,200614,2037,1345,31607,239600
42013,7,106,0,26,64,203
11239,856,12280,582,478,7088,21284
24321,13,713,4,21,110,861
34959,484,2499,226,210,1198,4617
4660,13,318,5,32,198,566
1167,468,3165,377,621,3888,8519
19111,8618,176297,4887,4212,39081,233095
9211,249,1589,165,125,783,2911
35286,1458,12331,564,662,9022,24037
22953,16,154,4,40,67,281
35498,1108,7823,422,429,2094,11876
3514,44,158,26,99,634,961
3090,447,18921,344,232,5546,25490
183,605,7899,535,642,3534,13215
996,2432,73792,1989,1232,20055,99500
17219,13,159,7,63,96,338
13757,330,5594,179,145,3158,9406
7877,97,1482,55,71,1903,3608
38018,35,49,14,48,259,405
36040,1002,6100,503,1513,6424,15542
4316,18,236,12,50,198,514
11689,15,2104,5,60,170,2354
35682,7,45,12,37,280,381
10200,9,97,6,63,96,271
34003,85,1099,31,33,660,1908
9956,11,41,4,44,51,151
634,3147,33609,2099,3017,36311,78183
1016,1309,32427,623,364,17513,52236
39489,0,0,0,0,6604,6604
41567,0,0,0,0,58319,58319
23711,19,353,10,49,187,618
17345,656,9633,305,225,5856,16675
31261,6,304,7,24,73,414
1429,101,3068,90,88,2065,5412
36458,1516,3262,437,1826,5443,12484
50352,1,87,0,2,10,100
37194,6,63,3,48,37,157
24935,99,4785,57,51,1147,6139
43494,0,7,2,5,10,24
40603,4,107,1,13,19,144
41062,138,139,49,240,619,1185
3531,135,1040,84,93,459,1811
34841,18,57,7,52,120,254
39940,27174,385544,7215,6025,78018,503976
5554,67,764,36,77,858,1802
2022,49,654,28,33,484,1248
29283,19,131,16,44,155,365
16810,18,79,7,60,118,282
3079,380,1462,338,227,3234,5641
30796,17,54,1,51,76,199
40066,93,647,24,48,1015,1827
48198,2,7,1,17,26,53
23447,757,33364,383,203,9418,44125
29103,6,141,3,31,33,214
21487,20,130,16,79,145,390
37126,764,3799,212,261,2030,7066
2057,79,1659,41,67,1029,2875
3213,99,690,81,162,1143,2175
10239,10,74,6,48,77,215
32225,7,48,5,47,52,159
27951,25,190,15,29,199,458
49861,13,782,9,7,110,921
44208,1055,5539,238,339,4645,11816
5051,74,1490,56,79,1157,2856
39786,7,198,5,11,47,268
1911,368,5039,312,213,6262,12194
40491,604,12413,145,124,5630,18916
43917,1,52,2,8,18,81
16434,140,1392,43,70,1940,3585
9317,56,417,32,78,277,860
2407,100,4616,69,82,1210,6077
49430,0,0,0,0,2795,2795
37589,492,1839,223,190,2648,5392
4531,103,2597,58,122,1322,4202
43539,0,7,1,6,12,26
29924,10,56,20,77,64,227
49160,0,0,0,0,4272,4272
8356,17,139,12,82,163,413
29477,8,72,5,49,60,194
49556,0,0,0,0,10016,10016
51043,16,194,4,6,106,326
35145,4360,62981,1867,1071,19880,90159
39012,11,26,6,51,52,146
39503,2,9,3,32,25,71
25915,47,466,24,52,718,1307
48126,3,18,2,21,33,77
36750,14,536,5,18,80,653
6796,52,512,27,46,756,1393
50600,0,0,0,0,83,83
35119,11,193,0,18,50,272
58,3114,33837,2723,3412,29218,72304
31486,102,1816,66,97,1814,3895
37409,40,76,28,36,111,291
49845,0,0,0,0,82,82
16263,14,83,8,51,218,374
48301,1,11,0,15,21,48
39805,13,94,6,19,188,320
34281,24627,293137,8973,14499,73988,415224
2565,87,1132,60,193,807,2279
38954,13,238,9,60,196,516
45869,1,4,0,11,17,33
49223,1091,0,102,119,2736,4048
598,274,5226,346,435,2605,8886
18845,88,1593,57,193,293,2224
792,227,15463,198,123,3085,19096
31236,23,100,16,57,289,485
22541,22,174,12,82,163,453
38779,333,2769,197,155,1214,4668
8243,15,47,6,54,183,305
13855,373,4595,187,179,3383,8717
38217,862,9514,308,466,4580,15730
815,216,16989,118,138,2538,19999
6377,4279,49520,3418,2048,39016,98281
3273,45,543,23,84,503,1198
41673,3,103,2,13,32,153
15611,1240,13932,727,916,3234,20049
20239,21,83,9,74,160,347
8291,947,6283,477,369,2768,10844
30390,89,510,49,76,769,1493
33056,230,3197,76,109,2101,5713
5845,92,4565,105,142,1842,6746
31211,28,190,8,75,145,446
1159,65,932,54,48,562,1661
47951,0,5,0,10,12,27
33102,273,3484,167,134,3129,7187
50230,7,8,0,8,18,41
9504,61,210,34,72,269,646
3968,67,692,47,63,829,1698
23889,17,86,9,45,190,347
22013,210,2486,195,283,4101,7275
33283,12,464,3,38,79,596
47022,1,6,1,12,19,39
10238,17,103,13,63,130,326
4038,2682,13328,2320,2696,21730,42756
36637,169,1685,44,123,1052,3073
2765,64,1339,33,78,672,2186
9318,15,635,6,32,155,843
32915,1003,31921,576,285,15697,49482
22225,2412,10616,1474,5023,11750,31275
18569,31,97,10,52,295,485
28765,11,427,4,31,64,537
40092,7,62,5,44,81,199
42925,2,66,1,7,14,90
2889,1898,196652,959,533,18440,218482
41114,4,51,4,19,44,122
34178,464,4038,196,212,1507,6417
34992,7,279,4,26,40,356
2041,333,5524,589,967,2008,9421
9342,93,2264,40,91,1154,3642
40421,2805,119253,843,457,50373,173731
1331,212,3602,139,215,1244,5412
25365,77,4603,84,109,1292,6165
6368,346,4042,200,193,5061,9842
41121,5,25,2,13,33,78
29786,38082,474188,18535,24919,134978,690702
42387,638,2768,477,210,18228,22321
32502,166,1384,104,97,1666,3417
1655,355,3899,466,530,2997,8247
41118,8,34,4,19,105,170
25923,809,4129,365,265,1746,7314
8211,351,9868,201,268,4134,14822
37324,264,544,176,170,876,2030
1276,324,3178,215,267,3329,7313
34701,11,41,3,44,56,155
5375,35,551,48,185,235,1054
40228,651,7837,291,436,3099,12314
14957,157,3856,170,199,3014,7396
12351,31,549,22,37,373,1012
41656,3,88,3,6,18,118
22099,288,608,198,743,899,2736
38373,133,106,47,31,4688,5005
41034,3,150,3,7,21,184
46,642,36575,479,263,9729,47688
8769,21026,452365,11850,22621,121234,629096
24881,12,135,19,98,109,373
6169,195,3742,139,117,3444,7637
41635,6,68,3,50,34,161
7621,25,489,22,73,405,1014
8464,57,607,24,56,499,1243
31485,152,2672,75,141,1706,4746
37146,16,55,7,29,149,256
35666,7,105,2,25,49,188
48024,0,4,0,12,13,29
35276,8,25,1,43,35,112
8876,4726,52045,2349,1728,24414,85262
31116,10,143,1,41,50,245
42383,594,0,198,80,711,1583
28241,15,725,9,63,153,965
641,224,14000,218,143,3072,17657
441,721,29834,418,298,13131,44402
43318,6,147,2,9,31,195
47254,6,134,1,5,28,174
6385,101,9578,99,147,1694,11619
3576,763,15645,698,1440,2353,20899
49661,160,1027,38,31,1308,2564
40333,0,0,0,0,63019,63019
38971,284,5939,174,177,3353,9927
42698,3,52,1,15,33,104
29475,9,140,4,43,72,268
2221,359,3858,406,450,2406,7479
42923,61466,228771,11401,11485,101672,414795
19965,14,86,11,59,114,284
15605,6529,118123,3569,12554,25002,165777
31537,8648,34188,3257,7158,52020,105271
28035,13,301,4,54,94,466
42922,4,13,0,15,27,59
39332,38,627,31,82,615,1393
6749,71,3567,56,105,1239,5038
25681,13330,248048,6260,4195,53245,325078
8928,36,354,14,59,324,787
25081,16,106,10,59,143,334
39178,141,1576,30,78,576,2401
47070,1,4,0,12,16,33
7176,192,1589,215,500,703,3199
31642,10,28,1,45,38,122
1453,4571,16937,3545,2458,32998,60509
7082,1909,48057,1743,4290,11601,67600
6117,579,2321,491,1086,2953,7430
35450,15,356,3,26,87,487
31229,19029,130753,9798,19711,64817,244108
39938,0,0,0,0,5471,5471
37259,11456,78071,5226,11367,36984,143104
1454,3128,20654,2416,2405,38081,66684
4031,71,1228,39,56,885,2279
32105,62226,192756,31731,49720,111020,447453
30850,116,957,67,99,1567,2806
42546,8,125,5,37,99,274
11077,2924,52422,1407,577,27711,85041
15781,107,2546,69,99,1370,4191
21541,947,20424,513,406,8974,31264
10336,2425,19021,2202,2474,16089,42211
783,306,2214,223,400,2641,5784
16183,51,544,51,77,955,1678
37167,28,48,11,28,214,329
31115,124,5830,68,117,1591,7730
3885,40,194,30,82,486,832
42233,3,90,1,7,44,145
40881,256,7869,165,97,8291,16678
43417,7,147,2,15,68,239
28723,73,738,33,117,696,1657
984,507,38149,306,298,5411,44671
1570,1482,19914,1253,1968,9520,34137
591,2952,44632,2672,4870,14602,69728
43987,1,28,0,18,23,70
2713,241,2864,269,194,2151,5719
41235,760,710,227,230,565,2492
12055,1190,10067,569,468,3276,15570
27757,30,301,24,133,181,669
934,43550,409852,36773,34000,197706,721881
15785,197,9109,128,157,1943,11534
9588,532,2693,277,222,1590,5314
10607,29,231,23,98,217,598
3035,167,532,120,139,1686,2644
6060,38,647,19,57,460,1221
1005,467,7045,582,817,3170,12081
11695,25,177,17,87,209,515
37026,116,461,44,42,964,1627
50869,0,0,1,0,1236,1237
37623,447,14160,229,194,6782,21812
5880,11,881,5,23,180,1100
3919,481,2872,265,232,1351,5201
22785,458,1756,182,247,4191,6834
40036,24,37,13,36,405,515
29401,12,52,8,49,55,176
34821,395,2100,190,196,1061,3942
34818,478,1758,240,227,2015,4718
14663,343,9235,179,171,3692,13620
19745,12,74,4,40,87,217
34315,12,55,10,59,102,238
7155,40,392,21,84,433,970
39421,1124,2246,364,651,4308,8693
36734,6,77,7,37,49,176
39856,6,304,0,15,50,375
49095,1339,0,410,183,2450,4382
5196,249,6531,209,164,3478,10631
7525,25,97,20,64,214,420
39611,29,38,23,49,129,268
1299,868,4369,975,1021,11425,18658
33769,1145,4261,529,337,2319,8591
35334,468,2094,327,497,3206,6592
2438,604,4909,357,311,1997,8178
37169,0,0,0,0,3959,3959
1815,926,42640,758,510,14968,59802
33600,13,45,1,52,77,188
969,3308,75564,3623,3090,25267,110852
48442,0,0,0,0,1362,1362
40440,7,59,5,34,42,147
7334,841,34604,527,1393,3412,40777
37963,651,5216,186,330,5955,12338
39169,0,0,0,0,5994,5994
21451,66,2895,17,33,580,3591
31872,8,123,2,36,37,206
49370,157,1,17,41,168,384
21707,85,747,52,106,1015,2005
32686,23378,204691,11439,25955,88564,354027
34522,886,4352,437,752,5844,12271
36685,54,1129,25,57,917,2182
14993,544,5553,293,274,1560,8224
851,1961,10529,1186,707,13906,28289
9850,16,400,7,53,125,601
29507,8,57,5,57,52,179
39942,1969,6438,874,2234,8633,20148
33278,37,170,19,64,258,548
49558,0,0,0,0,1703,1703
43498,0,4,1,7,11,23
3152,90,1083,29,47,1300,2549
43985,1,38,0,20,22,81
33934,210,7566,86,69,3394,11325
131,817,11361,749,561,7918,21406
43677,0,5,0,9,11,25
32014,13,66,8,55,88,230
42526,7,209,2,8,30,256
31586,35,3488,17,49,247,3836
13643,221,1827,151,126,844,3169
17979,14,156,8,40,110,328
14117,568,7336,366,329,8343,16942
3370,120,1097,70,111,641,2039
38132,3,85,2,43,31,164
128,243,6122,284,291,2948,9888
17131,34,151,10,48,302,545
1363,608,49686,246,287,3843,54670
6721,60,1372,46,129,761,2368
46352,64455,111181,9335,11493,107025,303489
35541,82,313,48,110,249,802
48111,2,3,0,8,15,28
38400,482,2224,349,91,44366,47512
1436,116,4177,87,92,2045,6517
4481,80,1480,40,97,1006,2703
27967,713,10125,330,179,6577,17924
20141,109,2788,84,87,1870,4938
8666,345,6618,206,224,3418,10811
3883,295,1326,144,227,1616,3608
41834,10502,13881,2890,9373,20361,57007
43415,6,153,3,5,28,195
32784,7,176,3,18,30,234
2065,71,1108,53,69,755,2056
30839,8,76,6,51,95,236
31750,62,1595,77,134,821,2689
1068,199,1224,193,195,1289,3100
30840,26,368,30,70,372,866
10118,24,222,38,70,396,750
5396,24,299,25,55,340,743
40131,44,360,29,42,197,672
23247,570,2933,263,165,972,4903
300,791,14911,673,804,7806,24985
5564,67,490,49,123,341,1070
1840,10106,394328,5545,6200,43434,459613
31009,6,28,4,44,33,115
8359,71,5508,43,109,627,6358
306,3435,38477,3476,3466,31164,80018
38147,22,44,10,114,190,380
4107,2543,103644,1324,819,37864,146194
1619,375,13593,268,185,4588,19009
4562,222,1306,123,150,772,2573
19195,655,22811,371,190,13278,37305
10521,6825,186387,4037,2797,42778,242824
8659,11,396,5,30,118,560
47402,79,2724,21,26,778,3628
44881,14329,59885,2239,3604,31583,111640
9376,30,244,18,58,312,662
34839,5705,20018,2714,4838,17809,51084
3557,153,1359,97,116,602,2327
12293,14818,255223,7843,13394,58585,349863
1901,193,5095,112,118,4361,9879
31754,559,26880,276,216,5967,33898
37318,226,677,70,87,1261,2321
37605,5,141,0,14,38,198
3858,86,1726,109,297,432,2650
32071,1517,67607,472,537,15458,85591
7547,21,228,8,53,168,478
53,4577,63734,4450,6242,23581,102584
48820,0,0,0,0,41674,41674
548,713,19221,362,359,12342,32997
40762,112,2051,48,77,1559,3847
21097,2510,16402,794,580,4314,24600
884,357,11693,189,180,4964,17383
38150,1285,3221,491,2075,6277,13349
49827,0,0,0,0,2650,2650
30984,5,46,1,51,38,141
16778,13,111,5,48,102,279
40529,5421,31404,1975,2370,27449,68619
9990,120,986,58,58,2204,3426
39323,19,340,12,21,220,612
39122,4,29,1,29,29,92
40469,19,496,27,23,200,765
38006,1,0,0,0,8397,8398
30204,16,95,6,38,149,304
38384,16,55,8,36,93,208
5581,28,238,10,45,210,531
23179,233,2699,117,188,2028,5265
38436,336,3493,72,123,1320,5344
25265,53,680,25,47,670,1475
29932,18,507,10,39,115,689
28687,15,641,6,29,79,770
38026,393,2117,241,216,11125,14092
5324,238,2309,169,192,1221,4129
26101,8,60,3,57,108,236
37345,43106,143845,13296,37271,83308,320826
355,22060,307686,19697,22643,127299,499385
38972,1010,24390,338,643,7625,34006
17205,390,16303,247,220,7791,24951
1891,89,886,69,131,725,1900
42444,7,90,8,31,63,199
42277,2,101,2,11,45,161
6718,65,651,51,96,872,1735
22319,92158,2037051,31309,49520,206693,2416731
11433,13953,207995,8844,10175,107385,348352
35141,13,108,6,55,86,268
22709,15,109,6,70,86,286
1397,1374,12962,1348,1279,10339,27302
26015,5,351,3,49,55,463
21335,444,1786,416,810,2013,5469
18661,6036,85775,1177,519,16912,110419
28179,129,4429,74,68,1352,6052
29585,9,355,3,39,90,496
36121,1184,4899,540,439,2533,9595
32088,20,216,15,71,349,671
35158,31,280,18,70,321,720
4890,25,1839,11,25,302,2202
9566,41,1013,13,43,354,1464
